abducted	cat=ppl
adsorbing	cat=ppl
applied	cat=ppl
avenged	cat=ppl
babbling	cat=ppl
based	cat=ppl
beaten	cat=ppl
breaking	cat=ppl
burned	cat=ppl
burnt	cat=ppl
calibrated	cat=ppl
cantering	cat=ppl
carbonized	cat=ppl
carinate	cat=ppl
carinated	cat=ppl
charred	cat=ppl
chattering	cat=ppl
closed-captioned	cat=ppl
collected	cat=ppl
containerised	cat=ppl
containerized	cat=ppl
contested	cat=ppl
cooing	cat=ppl
corbelled	cat=ppl
counterbalancing	cat=ppl
crunched	cat=ppl
curdling	cat=ppl
cursing	cat=ppl
deposed	cat=ppl
developing	cat=ppl
dimpled	cat=ppl
disappearing	cat=ppl
dissolving	cat=ppl
docked	cat=ppl
drawn	cat=ppl
dumped	cat=ppl
elapsed	cat=ppl
embodied	cat=ppl
emerging	cat=ppl
emitting	cat=ppl
exploded	cat=ppl
extrapolated	cat=ppl
forced	cat=ppl
galloping	cat=ppl
gathered	cat=ppl
graduated	cat=ppl
greening	cat=ppl
hammered	cat=ppl
handheld	cat=ppl
hand-held	cat=ppl
held	cat=ppl
hijacking	cat=ppl
hydrogenated	cat=ppl
hypophysectomised	cat=ppl
hypophysectomized	cat=ppl
irritated	cat=ppl
keeled	cat=ppl
kidnaped	cat=ppl
kidnapped	cat=ppl
living	cat=ppl
marched upon	cat=ppl
mercerised	cat=ppl
mercerized	cat=ppl
mounded over	cat=ppl
notifiable	cat=ppl
operating	cat=ppl
oxidised	cat=ppl
oxidized	cat=ppl
parked	cat=ppl
pasteurised	cat=ppl
pasteurized	cat=ppl
penciled	cat=ppl
pencilled	cat=ppl
peptising	cat=ppl
peptizing	cat=ppl
permeated	cat=ppl
pitched	cat=ppl
played	cat=ppl
plugged	cat=ppl
pointing	cat=ppl
posed	cat=ppl
posted	cat=ppl
preconceived	cat=ppl
produced	cat=ppl
pulled	cat=ppl
punishing	cat=ppl
pursued	cat=ppl
ranging	cat=ppl
re-created	cat=ppl
regenerating	cat=ppl
remembered	cat=ppl
resublimed	cat=ppl
ridged	cat=ppl
sanitised	cat=ppl
sanitized	cat=ppl
saponified	cat=ppl
scolding	cat=ppl
seeking	cat=ppl
shrieked	cat=ppl
sintered	cat=ppl
sluicing	cat=ppl
sought	cat=ppl
spray-dried	cat=ppl
squashed	cat=ppl
stacked	cat=ppl
stored	cat=ppl
straitened	cat=ppl
streaming	cat=ppl
strung	cat=ppl
sublimated	cat=ppl
sublimed	cat=ppl
surmounted	cat=ppl
thoriated	cat=ppl
tittering	cat=ppl
transpiring	cat=ppl
unavenged	cat=ppl
unburned	cat=ppl
uncollected	cat=ppl
uncontested	cat=ppl
ungathered	cat=ppl
unpasteurised	cat=ppl
unpasteurized	cat=ppl
unposed	cat=ppl
unsaponified	cat=ppl
vanishing	cat=ppl
worshiping	cat=ppl
worshipping	cat=ppl
abasic	cat=pert
abatic	cat=pert
abbatial	cat=pert
abdominal	cat=pert
abdominovesical	cat=pert
aberdonian	cat=pert
abient	cat=pert
abiogenetic	cat=pert
ablative	cat=pert
abolitionary	cat=pert
abomasal	cat=pert
absolutist	cat=pert
absolutistic	cat=pert
abyssal	cat=pert
academic	cat=pert
acanthotic	cat=pert
acapnial	cat=pert
acapnic	cat=pert
acapnotic	cat=pert
accentual	cat=pert
accessional	cat=pert
accipitrine	cat=pert
accommodational	cat=pert
acculturational	cat=pert
acculturative	cat=pert
accusative	cat=pert
accusatorial	cat=pert
acentric	cat=pert
acervate	cat=pert
acetic	cat=pert
acetonic	cat=pert
acetylenic	cat=pert
acetylic	cat=pert
achenial	cat=pert
achlorhydric	cat=pert
achondritic	cat=pert
achondroplastic	cat=pert
achromatinic	cat=pert
aciculate	cat=pert
acidimetric	cat=pert
acidotic	cat=pert
acinar	cat=pert
acinic	cat=pert
acinose	cat=pert
acinous	cat=pert
acneiform	cat=pert
acoustic	cat=pert
acoustical	cat=pert
acrocentric	cat=pert
acrogenic	cat=pert
acrogenous	cat=pert
acronymic	cat=pert
acronymous	cat=pert
actinic	cat=pert
actinometric	cat=pert
actinometrical	cat=pert
actinomycetal	cat=pert
actinomycetous	cat=pert
actinomycotic	cat=pert
actuarial	cat=pert
aculeate	cat=pert
aculeated	cat=pert
adactylous	cat=pert
adamantine	cat=pert
adenocarcinomatous	cat=pert
adenoid	cat=pert
adenoidal	cat=pert
adient	cat=pert
adjectival	cat=pert
adjective	cat=pert
adjudicative	cat=pert
adjudicatory	cat=pert
administrative	cat=pert
adnexal	cat=pert
adolescent	cat=pert
adrenal	cat=pert
adrenergic	cat=pert
adrenocortical	cat=pert
advective	cat=pert
adventitial	cat=pert
adventuristic	cat=pert
adverbial	cat=pert
aecial	cat=pert
aegean	cat=pert
aeolian	cat=pert
aeonian	cat=pert
aeriferous	cat=pert
aerodynamic	cat=pert
aerolitic	cat=pert
aerological	cat=pert
aeromechanic	cat=pert
aeromedical	cat=pert
aeronautic	cat=pert
aeronautical	cat=pert
aerophilatelic	cat=pert
aeschylean	cat=pert
aesculapian	cat=pert
aesthetic	cat=pert
aetiologic	cat=pert
aetiological	cat=pert
afebrile	cat=pert
affixal	cat=pert
affixial	cat=pert
afghan	cat=pert
afghani	cat=pert
afghanistani	cat=pert
african	cat=pert
afrikaans	cat=pert
afrikaner	cat=pert
afro-asian	cat=pert
agential	cat=pert
agonadal	cat=pert
agonal	cat=pert
agonistic	cat=pert
agranulocytic	cat=pert
agraphic	cat=pert
agricultural	cat=pert
agrobiologic	cat=pert
agrobiological	cat=pert
agrologic	cat=pert
agrological	cat=pert
agronomic	cat=pert
agronomical	cat=pert
agrypnotic	cat=pert
ahistorical	cat=pert
air-breathing	cat=pert
alabastrine	cat=pert
alar	cat=pert
alaskan	cat=pert
albanian	cat=pert
albigensian	cat=pert
albinal	cat=pert
albinic	cat=pert
albinistic	cat=pert
albinotic	cat=pert
albitic	cat=pert
albuminous	cat=pert
albuminuric	cat=pert
alchemic	cat=pert
alchemical	cat=pert
alchemistic	cat=pert
alchemistical	cat=pert
aldehydic	cat=pert
aldermanic	cat=pert
aldermanly	cat=pert
aleuronic	cat=pert
alexandrian	cat=pert
alexic	cat=pert
algal	cat=pert
algebraic	cat=pert
algebraical	cat=pert
algerian	cat=pert
algoid	cat=pert
algolagnic	cat=pert
algometric	cat=pert
algometrical	cat=pert
algonkian	cat=pert
algonquian	cat=pert
algonquin	cat=pert
alimentative	cat=pert
alkahestic	cat=pert
alkaloidal	cat=pert
alkalotic	cat=pert
alkylic	cat=pert
allantoic	cat=pert
allelic	cat=pert
allelomorphic	cat=pert
allergenic	cat=pert
allergic	cat=pert
alliaceous	cat=pert
allogamous	cat=pert
allographic	cat=pert
allomerous	cat=pert
allometric	cat=pert
allomorphic	cat=pert
allopathic	cat=pert
allophonic	cat=pert
allotropic	cat=pert
allotropical	cat=pert
alluvial	cat=pert
allylic	cat=pert
alopecic	cat=pert
alphabetic	cat=pert
alphabetical	cat=pert
alphameric	cat=pert
alphamerical	cat=pert
alphanumeric	cat=pert
alphanumerical	cat=pert
alpine	cat=pert
alsatian	cat=pert
altaic	cat=pert
altitudinal	cat=pert
alular	cat=pert
aluminous	cat=pert
alveolar	cat=pert
alvine	cat=pert
amalgamative	cat=pert
amaranthine	cat=pert
amaurotic	cat=pert
ambassadorial	cat=pert
amblyopic	cat=pert
ambrosian	cat=pert
ambulacral	cat=pert
ameban	cat=pert
amebic	cat=pert
ameboid	cat=pert
amebous	cat=pert
amenorrheal	cat=pert
amenorrheic	cat=pert
amenorrhoeal	cat=pert
amenorrhoeic	cat=pert
american	cat=pert
amerind	cat=pert
amerindic	cat=pert
amethystine	cat=pert
amharic	cat=pert
aminic	cat=pert
amino	cat=pert
amitotic	cat=pert
ammino	cat=pert
ammoniac	cat=pert
ammoniacal	cat=pert
ammoniated	cat=pert
ammonitic	cat=pert
amnesic	cat=pert
amnestic	cat=pert
amnic	cat=pert
amnionic	cat=pert
amniotic	cat=pert
amoeban	cat=pert
amoebic	cat=pert
amoeboid	cat=pert
amoebous	cat=pert
amoristic	cat=pert
amphibian	cat=pert
amphibious	cat=pert
amphitheatric	cat=pert
amphitheatrical	cat=pert
amphoric	cat=pert
ampullar	cat=pert
ampullary	cat=pert
amygdaline	cat=pert
amylolytic	cat=pert
anabiotic	cat=pert
anabolic	cat=pert
anaclitic	cat=pert
anacoluthic	cat=pert
anaemic	cat=pert
anaglyphic	cat=pert
anaglyphical	cat=pert
anaglyptic	cat=pert
anaglyptical	cat=pert
anagogic	cat=pert
anagogical	cat=pert
anagrammatic	cat=pert
anagrammatical	cat=pert
anal	cat=pert
analphabetic	cat=pert
analytic	cat=pert
anamnestic	cat=pert
anamorphic	cat=pert
anaphasic	cat=pert
anaphoric	cat=pert
anaphylactic	cat=pert
anaplastic	cat=pert
anarchistic	cat=pert
anasarcous	cat=pert
anastigmatic	cat=pert
anastomotic	cat=pert
anatomic	cat=pert
anatomical	cat=pert
ancestral	cat=pert
andalusian	cat=pert
andean	cat=pert
andorran	cat=pert
androgenetic	cat=pert
androgenic	cat=pert
androgenous	cat=pert
anecdotal	cat=pert
anemic	cat=pert
anemographic	cat=pert
anemometric	cat=pert
anemometrical	cat=pert
anencephalic	cat=pert
anencephalous	cat=pert
aneroid	cat=pert
anestric	cat=pert
anestrous	cat=pert
aneuploid	cat=pert
aneurismal	cat=pert
aneurismatic	cat=pert
aneurysmal	cat=pert
aneurysmatic	cat=pert
angelic	cat=pert
angelical	cat=pert
anginal	cat=pert
anginose	cat=pert
anginous	cat=pert
angiocarpic	cat=pert
angiocarpous	cat=pert
angiomatous	cat=pert
angiospermous	cat=pert
anglican	cat=pert
anglo-catholic	cat=pert
anglo-indian	cat=pert
anglo-jewish	cat=pert
anglophilic	cat=pert
anglophobic	cat=pert
anglo-saxon	cat=pert
angolan	cat=pert
anguillan	cat=pert
anguine	cat=pert
angular	cat=pert
anicteric	cat=pert
animalistic	cat=pert
animatistic	cat=pert
animist	cat=pert
animistic	cat=pert
anionic	cat=pert
aniseikonic	cat=pert
anisogametic	cat=pert
anisogamic	cat=pert
anisogamous	cat=pert
anisometropic	cat=pert
ankylotic	cat=pert
annalistic	cat=pert
annelid	cat=pert
annelidan	cat=pert
annexal	cat=pert
annexational	cat=pert
annual	cat=pert
annunciatory	cat=pert
anodal	cat=pert
anodic	cat=pert
anoestrous	cat=pert
anoperineal	cat=pert
anopheline	cat=pert
anorectal	cat=pert
anorthitic	cat=pert
anosmatic	cat=pert
anosmic	cat=pert
anoxemic	cat=pert
anoxic	cat=pert
anserine	cat=pert
antarctic	cat=pert
antecubital	cat=pert
antediluvial	cat=pert
antediluvian	cat=pert
antennal	cat=pert
antennary	cat=pert
antenuptial	cat=pert
antheridial	cat=pert
anthracitic	cat=pert
anthropic	cat=pert
anthropical	cat=pert
anthropocentric	cat=pert
anthropogenetic	cat=pert
anthropogenic	cat=pert
anthropological	cat=pert
anthropometric	cat=pert
anthropometrical	cat=pert
anthropophagous	cat=pert
antiadrenergic	cat=pert
anti-american	cat=pert
antiapartheid	cat=pert
antibacterial	cat=pert
antibiotic	cat=pert
anticancer	cat=pert
anticlimactic	cat=pert
anticlimactical	cat=pert
anticoagulative	cat=pert
anticyclonic	cat=pert
antiferromagnetic	cat=pert
antifungal	cat=pert
antigenic	cat=pert
antiguan	cat=pert
antimonial	cat=pert
antimonic	cat=pert
antimonious	cat=pert
antineoplastic	cat=pert
antinomian	cat=pert
antiphonal	cat=pert
antiphonary	cat=pert
antipodal	cat=pert
antipodean	cat=pert
antipollution	cat=pert
antiquarian	cat=pert
antisatellite	cat=pert
anti-semitic	cat=pert
antistrophic	cat=pert
antithyroid	cat=pert
antitumor	cat=pert
antitumour	cat=pert
antitypic	cat=pert
antitypical	cat=pert
antiviral	cat=pert
anuran	cat=pert
anuretic	cat=pert
anuric	cat=pert
anxiolytic	cat=pert
aoristic	cat=pert
aortal	cat=pert
aortic	cat=pert
aphaeretic	cat=pert
aphakic	cat=pert
aphanitic	cat=pert
aphasic	cat=pert
apheretic	cat=pert
aphetic	cat=pert
aphoristic	cat=pert
apian	cat=pert
apiarian	cat=pert
apicultural	cat=pert
aplitic	cat=pert
apneic	cat=pert
apnoeic	cat=pert
apocalyptic	cat=pert
apocryphal	cat=pert
apocynaceous	cat=pert
apogametic	cat=pert
apogamic	cat=pert
apogamous	cat=pert
apogean	cat=pert
apomictic	cat=pert
apomictical	cat=pert
aponeurotic	cat=pert
apopemptic	cat=pert
apophatic	cat=pert
apophyseal	cat=pert
apoplectic	cat=pert
apoplectiform	cat=pert
apoplectoid	cat=pert
aposiopetic	cat=pert
apostolic	cat=pert
apostolical	cat=pert
apostrophic	cat=pert
apothecial	cat=pert
apothegmatic	cat=pert
apothegmatical	cat=pert
appalachian	cat=pert
appellant	cat=pert
appellate	cat=pert
appellative	cat=pert
appendicular	cat=pert
appetitive	cat=pert
appointive	cat=pert
appositional	cat=pert
appositive	cat=pert
appropriative	cat=pert
apsidal	cat=pert
aptitudinal	cat=pert
aquacultural	cat=pert
aquatic	cat=pert
aqueous	cat=pert
aquicultural	cat=pert
aquiferous	cat=pert
arabian	cat=pert
arabic	cat=pert
araceous	cat=pert
arachnidian	cat=pert
arachnoid	cat=pert
aramaean	cat=pert
aramaic	cat=pert
aramean	cat=pert
araneidal	cat=pert
araneidan	cat=pert
arawakan	cat=pert
arbitral	cat=pert
arbitrational	cat=pert
arbitrative	cat=pert
arborary	cat=pert
arboreal	cat=pert
arborical	cat=pert
arborous	cat=pert
archaeologic	cat=pert
archaeological	cat=pert
archaistic	cat=pert
archangelic	cat=pert
archangelical	cat=pert
archdiocesan	cat=pert
archducal	cat=pert
arched	cat=pert
archegonial	cat=pert
archegoniate	cat=pert
archeologic	cat=pert
archeological	cat=pert
archepiscopal	cat=pert
archesporial	cat=pert
archidiaconal	cat=pert
archiepiscopal	cat=pert
archipelagic	cat=pert
architectonic	cat=pert
architectural	cat=pert
archival	cat=pert
archosaurian	cat=pert
arctic	cat=pert
areal	cat=pert
arenicolous	cat=pert
areolar	cat=pert
areolate	cat=pert
argentic	cat=pert
argentine	cat=pert
argentinian	cat=pert
argentous	cat=pert
argive	cat=pert
aristotelean	cat=pert
aristotelian	cat=pert
aristotelic	cat=pert
arithmetic	cat=pert
arithmetical	cat=pert
armenian	cat=pert
armillary	cat=pert
arminian	cat=pert
armorial	cat=pert
aroid	cat=pert
aromatic	cat=pert
arsenical	cat=pert
arsenious	cat=pert
artefactual	cat=pert
arterial	cat=pert
arteriolar	cat=pert
arteriosclerotic	cat=pert
arteriovenous	cat=pert
arthralgic	cat=pert
arthromeric	cat=pert
arthropodal	cat=pert
arthropodan	cat=pert
arthropodous	cat=pert
arthrosporic	cat=pert
arthrosporous	cat=pert
arthurian	cat=pert
articular	cat=pert
articulary	cat=pert
articulative	cat=pert
articulatory	cat=pert
artifactual	cat=pert
artiodactyl	cat=pert
artiodactylous	cat=pert
artistic	cat=pert
arundinaceous	cat=pert
aryan	cat=pert
asat	cat=pert
ascensional	cat=pert
ascetic	cat=pert
ascetical	cat=pert
ascitic	cat=pert
asclepiadaceous	cat=pert
ascocarpous	cat=pert
ascomycetous	cat=pert
ascosporic	cat=pert
ascosporous	cat=pert
asian	cat=pert
asiatic	cat=pert
aspectual	cat=pert
asphyxiated	cat=pert
assamese	cat=pert
associational	cat=pert
associative	cat=pert
asteriated	cat=pert
asterismal	cat=pert
asteroidal	cat=pert
astomatal	cat=pert
astragalar	cat=pert
astral	cat=pert
astrocytic	cat=pert
astrological	cat=pert
astronautic	cat=pert
astronautical	cat=pert
astronomic	cat=pert
astronomical	cat=pert
astrophysical	cat=pert
asymptotic	cat=pert
asynergic	cat=pert
atactic	cat=pert
ataxic	cat=pert
ateleiotic	cat=pert
atheist	cat=pert
atheistic	cat=pert
atheistical	cat=pert
athenian	cat=pert
atheromatic	cat=pert
atheromatous	cat=pert
atherosclerotic	cat=pert
athletic	cat=pert
atlantic	cat=pert
atmospheric	cat=pert
atmospherical	cat=pert
atomic	cat=pert
atonalistic	cat=pert
atonic	cat=pert
atrial	cat=pert
atrioventricular	cat=pert
atrophic	cat=pert
attentional	cat=pert
attic	cat=pert
attritional	cat=pert
auctorial	cat=pert
audenesque	cat=pert
audile	cat=pert
audio-lingual	cat=pert
audiometric	cat=pert
audiovisual	cat=pert
auditive	cat=pert
auditory	cat=pert
augitic	cat=pert
augustan	cat=pert
aural	cat=pert
auric	cat=pert
auricular	cat=pert
auriculoventricular	cat=pert
auroral	cat=pert
aurorean	cat=pert
aurous	cat=pert
auscultatory	cat=pert
austenitic	cat=pert
austral	cat=pert
australasian	cat=pert
australian	cat=pert
australopithecine	cat=pert
austrian	cat=pert
austronesian	cat=pert
autacoidal	cat=pert
autarchic	cat=pert
autarchical	cat=pert
autarkical	cat=pert
authorial	cat=pert
autobiographic	cat=pert
autobiographical	cat=pert
autocatalytic	cat=pert
autocratic	cat=pert
autocratical	cat=pert
autodidactic	cat=pert
autogenetic	cat=pert
autographic	cat=pert
autoimmune	cat=pert
autolytic	cat=pert
automotive	cat=pert
autophytic	cat=pert
autoplastic	cat=pert
autoradiographic	cat=pert
autosomal	cat=pert
autotelic	cat=pert
autotomic	cat=pert
autotrophic	cat=pert
autotypic	cat=pert
auxetic	cat=pert
auxinic	cat=pert
avascular	cat=pert
avellan	cat=pert
avellane	cat=pert
aversive	cat=pert
avestan	cat=pert
avian	cat=pert
avifaunal	cat=pert
avifaunistic	cat=pert
avionic	cat=pert
avitaminotic	cat=pert
avocational	cat=pert
avuncular	cat=pert
award-winning	cat=pert
axial	cat=pert
axile	cat=pert
axillary	cat=pert
axiological	cat=pert
axiomatic	cat=pert
axiomatical	cat=pert
axonal	cat=pert
azerbaijani	cat=pert
azido	cat=pert
azimuthal	cat=pert
azo	cat=pert
azotemic	cat=pert
azotic	cat=pert
baboonish	cat=pert
babylonian	cat=pert
baccate	cat=pert
bacchantic	cat=pert
bacillar	cat=pert
bacillary	cat=pert
back-channel	cat=pert
bacteremic	cat=pert
bacterial	cat=pert
bacterioid	cat=pert
bacterioidal	cat=pert
bacteriologic	cat=pert
bacteriological	cat=pert
bacteriolytic	cat=pert
bacteriophagic	cat=pert
bacteriophagous	cat=pert
bacteriostatic	cat=pert
bacteroid	cat=pert
bacteroidal	cat=pert
bahai	cat=pert
bahamian	cat=pert
bahraini	cat=pert
balkan	cat=pert
balletic	cat=pert
ballistic	cat=pert
balsamic	cat=pert
balsamy	cat=pert
baltic	cat=pert
balzacian	cat=pert
bangladeshi	cat=pert
bantoid	cat=pert
bantu	cat=pert
bantu-speaking	cat=pert
baptismal	cat=pert
baptist	cat=pert
baptistic	cat=pert
barbadian	cat=pert
bardic	cat=pert
baric	cat=pert
barographic	cat=pert
barometric	cat=pert
barometrical	cat=pert
barytic	cat=pert
basaltic	cat=pert
basidial	cat=pert
basidiomycetous	cat=pert
basidiosporous	cat=pert
basilar	cat=pert
basilary	cat=pert
basilican	cat=pert
basinal	cat=pert
basophilic	cat=pert
batholithic	cat=pert
batholitic	cat=pert
bathyal	cat=pert
bathymetric	cat=pert
bathymetrical	cat=pert
batrachian	cat=pert
bauxitic	cat=pert
bavarian	cat=pert
bayesian	cat=pert
beethovenian	cat=pert
behavioral	cat=pert
behaviorist	cat=pert
behavioristic	cat=pert
behavioural	cat=pert
behaviourist	cat=pert
behaviouristic	cat=pert
belarusian	cat=pert
belemnitic	cat=pert
belgian	cat=pert
benedictine	cat=pert
benedictive	cat=pert
benedictory	cat=pert
beneficiary	cat=pert
benevolent	cat=pert
bengali	cat=pert
beninese	cat=pert
benthal	cat=pert
benthic	cat=pert
benthonic	cat=pert
bentonitic	cat=pert
benzenoid	cat=pert
benzoic	cat=pert
benzylic	cat=pert
bermudan	cat=pert
berrylike	cat=pert
betulaceous	cat=pert
bhutanese	cat=pert
biannual	cat=pert
biauricular	cat=pert
biaxal	cat=pert
biaxate	cat=pert
biaxial	cat=pert
biblical	cat=pert
bibliographic	cat=pert
bibliographical	cat=pert
bibliolatrous	cat=pert
bibliomaniacal	cat=pert
bibliophilic	cat=pert
bibliopolic	cat=pert
bibliothecal	cat=pert
bibliothecarial	cat=pert
bibliotic	cat=pert
bicapsular	cat=pert
bicentenary	cat=pert
bicentennial	cat=pert
bichromated	cat=pert
bicipital	cat=pert
bicylindrical	cat=pert
biedermeier	cat=pert
biennial	cat=pert
bifilar	cat=pert
biflagellate	cat=pert
bignoniaceous	cat=pert
bilabial	cat=pert
biliary	cat=pert
bilious	cat=pert
billiard	cat=pert
bilobate	cat=pert
bilobated	cat=pert
bilobed	cat=pert
bimestrial	cat=pert
bimetallic	cat=pert
bimetallistic	cat=pert
bimillenial	cat=pert
bimolecular	cat=pert
bimonthly	cat=pert
bimorphemic	cat=pert
binary	cat=pert
binocular	cat=pert
binomial	cat=pert
biocatalytic	cat=pert
biochemical	cat=pert
bioclimatic	cat=pert
biogenetic	cat=pert
biogenic	cat=pert
biogenous	cat=pert
biogeographic	cat=pert
biogeographical	cat=pert
biographic	cat=pert
biographical	cat=pert
biologic	cat=pert
biological	cat=pert
biologistic	cat=pert
biomedical	cat=pert
bionic	cat=pert
bionomic	cat=pert
bionomical	cat=pert
biosynthetic	cat=pert
biosystematic	cat=pert
biotic	cat=pert
biotitic	cat=pert
biotypic	cat=pert
bipolar	cat=pert
biquadratic	cat=pert
birefringent	cat=pert
bisectional	cat=pert
bismarckian	cat=pert
bismuthal	cat=pert
bismuthic	cat=pert
bisontine	cat=pert
bistered	cat=pert
bistred	cat=pert
bistroic	cat=pert
bitumenoid	cat=pert
bituminoid	cat=pert
bituminous	cat=pert
bivalent	cat=pert
bivariate	cat=pert
biweekly	cat=pert
biyearly	cat=pert
bizonal	cat=pert
bladderlike	cat=pert
bladdery	cat=pert
bladed	cat=pert
blastemal	cat=pert
blastematic	cat=pert
blastemic	cat=pert
blastocoelic	cat=pert
blastodermatic	cat=pert
blastodermic	cat=pert
blastogenetic	cat=pert
blastomeric	cat=pert
blastomycotic	cat=pert
blastoporal	cat=pert
blastoporic	cat=pert
blastospheric	cat=pert
blastular	cat=pert
bodily	cat=pert
boeotian	cat=pert
bogartian	cat=pert
bohemian	cat=pert
bolivian	cat=pert
bolographic	cat=pert
bolometric	cat=pert
bolshevik	cat=pert
bolshevist	cat=pert
bolshevistic	cat=pert
bony	cat=pert
boole	cat=pert
boolean	cat=pert
boracic	cat=pert
borated	cat=pert
boreal	cat=pert
boric	cat=pert
boronic	cat=pert
boskopoid	cat=pert
bosnian	cat=pert
botanic	cat=pert
botanical	cat=pert
botryoid	cat=pert
botryoidal	cat=pert
botswanan	cat=pert
botulinal	cat=pert
boustrophedonic	cat=pert
bovid	cat=pert
bovine	cat=pert
boytrose	cat=pert
brachial	cat=pert
brachiopod	cat=pert
brachiopodous	cat=pert
brachyurous	cat=pert
bracteal	cat=pert
bracteate	cat=pert
bracted	cat=pert
bracteolate	cat=pert
brahminic	cat=pert
brahminical	cat=pert
branchial	cat=pert
branchiopod	cat=pert
branchiopodan	cat=pert
branchiopodous	cat=pert
brasslike	cat=pert
brassy	cat=pert
brazen	cat=pert
brazilian	cat=pert
breech-loading	cat=pert
bregmatic	cat=pert
bridal	cat=pert
brimless	cat=pert
brisant	cat=pert
britannic	cat=pert
british	cat=pert
briton	cat=pert
broadband	cat=pert
brobdingnagian	cat=pert
bromic	cat=pert
bromidic	cat=pert
bronchial	cat=pert
bronchiolar	cat=pert
bronchoscopic	cat=pert
bruneian	cat=pert
bryophytic	cat=pert
bubaline	cat=pert
bubonic	cat=pert
buccal	cat=pert
bucolic	cat=pert
buddhist	cat=pert
buddhistic	cat=pert
budgetary	cat=pert
bulbaceous	cat=pert
bulbar	cat=pert
bulbed	cat=pert
bulgarian	cat=pert
bulimic	cat=pert
bungaloid	cat=pert
bureaucratic	cat=pert
burglarious	cat=pert
burlesque	cat=pert
burmese	cat=pert
burrlike	cat=pert
bursal	cat=pert
burundi	cat=pert
burundian	cat=pert
buteonine	cat=pert
butyraceous	cat=pert
butyric	cat=pert
byzantine	cat=pert
cachectic	cat=pert
cacodaemonic	cat=pert
cacodemonic	cat=pert
cacodylic	cat=pert
cacogenic	cat=pert
cadastral	cat=pert
cadaveric	cat=pert
caducean	cat=pert
caecal	cat=pert
caecilian	cat=pert
caesarean	cat=pert
caesarian	cat=pert
caesural	cat=pert
caffeinic	cat=pert
cairned	cat=pert
calcaneal	cat=pert
calcareous	cat=pert
calceiform	cat=pert
calceolate	cat=pert
calcic	cat=pert
calciferous	cat=pert
calcific	cat=pert
calcitic	cat=pert
calculous	cat=pert
calcuttan	cat=pert
calendric	cat=pert
calendrical	cat=pert
calico	cat=pert
calicular	cat=pert
californian	cat=pert
calisthenic	cat=pert
calligraphic	cat=pert
calligraphical	cat=pert
callithumpian	cat=pert
caloric	cat=pert
calorimetric	cat=pert
calvinist	cat=pert
calvinistic	cat=pert
calvinistical	cat=pert
calyceal	cat=pert
calycinal	cat=pert
calycine	cat=pert
calycled	cat=pert
calycular	cat=pert
calyculate	cat=pert
calyptrate	cat=pert
cambial	cat=pert
cambodian	cat=pert
cambrian	cat=pert
cameroonian	cat=pert
campanular	cat=pert
campanulate	cat=pert
campanulated	cat=pert
camphoraceous	cat=pert
camphoric	cat=pert
canadian	cat=pert
canalicular	cat=pert
cancroid	cat=pert
canicular	cat=pert
canine	cat=pert
cannibalistic	cat=pert
canonic	cat=pert
canonical	cat=pert
canonist	cat=pert
cantonal	cat=pert
capacitive	cat=pert
capetian	cat=pert
capillary	cat=pert
capitalist	cat=pert
capitalistic	cat=pert
capitular	cat=pert
capitulary	cat=pert
cappadocian	cat=pert
caprine	cat=pert
capsular	cat=pert
carangid	cat=pert
carbocyclic	cat=pert
carbolated	cat=pert
carbonaceous	cat=pert
carbonic	cat=pert
carboniferous	cat=pert
carbonous	cat=pert
carbonyl	cat=pert
carbonylic	cat=pert
carboxyl	cat=pert
carboxylic	cat=pert
carcinogenic	cat=pert
carcinomatous	cat=pert
cardiac	cat=pert
cardiographic	cat=pert
cardiologic	cat=pert
cardiopulmonary	cat=pert
cardiorespiratory	cat=pert
cardiovascular	cat=pert
carinal	cat=pert
carinate	cat=pert
carinated	cat=pert
carmelite	cat=pert
carnal	cat=pert
carnivorous	cat=pert
carolean	cat=pert
caroline	cat=pert
carolingian	cat=pert
carotid	cat=pert
carpal	cat=pert
carpellary	cat=pert
carpetbag	cat=pert
carposporic	cat=pert
carposporous	cat=pert
carroty	cat=pert
cartesian	cat=pert
carthaginian	cat=pert
carthusian	cat=pert
cartographic	cat=pert
cartographical	cat=pert
caruncular	cat=pert
carunculate	cat=pert
carunculated	cat=pert
carunculous	cat=pert
caryophyllaceous	cat=pert
cash-and-carry	cat=pert
caspian	cat=pert
casuistic	cat=pert
casuistical	cat=pert
catabolic	cat=pert
catachrestic	cat=pert
catachrestical	cat=pert
catalan	cat=pert
catalatic	cat=pert
cataleptic	cat=pert
catalytic	cat=pert
catamenial	cat=pert
cataphatic	cat=pert
cataphoretic	cat=pert
cataplastic	cat=pert
catapultian	cat=pert
catapultic	cat=pert
catarrhal	cat=pert
catatonic	cat=pert
catechetic	cat=pert
catechetical	cat=pert
catechismal	cat=pert
catechistic	cat=pert
categorial	cat=pert
categorical	cat=pert
cathectic	cat=pert
cathedral	cat=pert
cathodic	cat=pert
catholic	cat=pert
cationic	cat=pert
catkinate	cat=pert
catoptric	cat=pert
catoptrical	cat=pert
caucasian	cat=pert
caucasic	cat=pert
caudal	cat=pert
cecal	cat=pert
celebratory	cat=pert
celestial	cat=pert
celiac	cat=pert
cellular	cat=pert
cellulosid	cat=pert
celtic	cat=pert
cementitious	cat=pert
cenobitic	cat=pert
cenobitical	cat=pert
cenogenetic	cat=pert
censorial	cat=pert
centenary	cat=pert
centennial	cat=pert
centesimal	cat=pert
central	cat=pert
central american	cat=pert
centralist	cat=pert
centralistic	cat=pert
centroidal	cat=pert
centromeric	cat=pert
centrosomic	cat=pert
cephalic	cat=pert
cephalopod	cat=pert
cephalopodan	cat=pert
ceramic	cat=pert
cercarial	cat=pert
cereal	cat=pert
cerebellar	cat=pert
cerebral	cat=pert
cerebrospinal	cat=pert
cerebrovascular	cat=pert
ceric	cat=pert
cerous	cat=pert
ceruminous	cat=pert
cervical	cat=pert
cervine	cat=pert
cesarean	cat=pert
cesarian	cat=pert
cetacean	cat=pert
cetaceous	cat=pert
ceylonese	cat=pert
chadian	cat=pert
chaetal	cat=pert
chaetognathan	cat=pert
chaetognathous	cat=pert
chafflike	cat=pert
chaffy	cat=pert
chaldaean	cat=pert
chaldean	cat=pert
chaldee	cat=pert
chalky	cat=pert
chalybeate	cat=pert
chancroidal	cat=pert
chancrous	cat=pert
chaotic	cat=pert
charitable	cat=pert
chartaceous	cat=pert
chasidic	cat=pert
chassidic	cat=pert
chechen	cat=pert
chelate	cat=pert
chelated	cat=pert
cheliceral	cat=pert
chelicerate	cat=pert
chelicerous	cat=pert
cheliferous	cat=pert
chelonian	cat=pert
chemic	cat=pert
chemical	cat=pert
chemiluminescent	cat=pert
chemoreceptive	cat=pert
chemotherapeutic	cat=pert
chemotherapeutical	cat=pert
cherty	cat=pert
chian	cat=pert
chiasmal	cat=pert
chiasmatic	cat=pert
chiasmic	cat=pert
childbearing	cat=pert
chilean	cat=pert
chiliastic	cat=pert
chimeral	cat=pert
chimeric	cat=pert
chimerical	cat=pert
chinese	cat=pert
chippendale	cat=pert
chiromantic	cat=pert
chitinous	cat=pert
chlamydial	cat=pert
chlorophyllose	cat=pert
chlorophyllous	cat=pert
chlorotic	cat=pert
choleraic	cat=pert
choragic	cat=pert
choral	cat=pert
chordal	cat=pert
chordate	cat=pert
choreographic	cat=pert
choric	cat=pert
chorionic	cat=pert
christian	cat=pert
christological	cat=pert
chromatic	cat=pert
chromatinic	cat=pert
chromatographic	cat=pert
chromatographical	cat=pert
chromosomal	cat=pert
chronological	cat=pert
churchillian	cat=pert
chylaceous	cat=pert
chylifactive	cat=pert
chylifactory	cat=pert
chyliferous	cat=pert
chylific	cat=pert
chylous	cat=pert
cilial	cat=pert
ciliary	cat=pert
ciliate	cat=pert
cinematic	cat=pert
cinerary	cat=pert
circadian	cat=pert
circulative	cat=pert
circulatory	cat=pert
cislunar	cat=pert
citric	cat=pert
citrous	cat=pert
civic	cat=pert
civil	cat=pert
clamatorial	cat=pert
classicistic	cat=pert
classificatory	cat=pert
clausal	cat=pert
cleistogamic	cat=pert
cleistogamous	cat=pert
clerical	cat=pert
climatic	cat=pert
climatical	cat=pert
clinical	cat=pert
clitoral	cat=pert
clitoric	cat=pert
clonal	cat=pert
clonic	cat=pert
closed-circuit	cat=pert
cloze	cat=pert
coastal	cat=pert
coccal	cat=pert
coccygeal	cat=pert
cochlear	cat=pert
cockney	cat=pert
coeliac	cat=pert
coenobitic	cat=pert
coenobitical	cat=pert
cogitative	cat=pert
cognitive	cat=pert
coin-operated	cat=pert
coital	cat=pert
coleridgean	cat=pert
coleridgian	cat=pert
collagenic	cat=pert
collagenous	cat=pert
collarless	cat=pert
collegial	cat=pert
collegiate	cat=pert
colloidal	cat=pert
colombian	cat=pert
colonial	cat=pert
colonic	cat=pert
colorectal	cat=pert
colorimetric	cat=pert
colorimetrical	cat=pert
columbian	cat=pert
comatose	cat=pert
cometary	cat=pert
cometic	cat=pert
comic	cat=pert
commemorating	cat=pert
commemorative	cat=pert
commensal	cat=pert
commercial	cat=pert
communal	cat=pert
communicative	cat=pert
communist	cat=pert
communistic	cat=pert
comparative	cat=pert
composite	cat=pert
computational	cat=pert
computer readable	cat=pert
conceptualistic	cat=pert
concessive	cat=pert
concretistic	cat=pert
condylar	cat=pert
conelike	cat=pert
cone-shaped	cat=pert
configurational	cat=pert
confrontational	cat=pert
confucian	cat=pert
congeneric	cat=pert
congenerical	cat=pert
congenerous	cat=pert
congestive	cat=pert
congolese	cat=pert
congregational	cat=pert
congregationalist	cat=pert
congressional	cat=pert
conic	cat=pert
conical	cat=pert
conjugal	cat=pert
conjunctival	cat=pert
connubial	cat=pert
consonantal	cat=pert
conspecific	cat=pert
conspirative	cat=pert
conspiratorial	cat=pert
constitutional	cat=pert
consubstantial	cat=pert
consular	cat=pert
contagious	cat=pert
contextual	cat=pert
continental	cat=pert
contractual	cat=pert
contrapuntal	cat=pert
convalescent	cat=pert
coptic	cat=pert
copular	cat=pert
copulatory	cat=pert
cordless	cat=pert
coreferential	cat=pert
corinthian	cat=pert
cormose	cat=pert
cormous	cat=pert
corneal	cat=pert
coronary	cat=pert
corporate	cat=pert
corpuscular	cat=pert
correlational	cat=pert
corsican	cat=pert
cortical	cat=pert
cortico-hypothalamic	cat=pert
corvine	cat=pert
corymbose	cat=pert
cosmic	cat=pert
cosmogenic	cat=pert
cosmogenical	cat=pert
cosmogonic	cat=pert
cosmogonical	cat=pert
cosmologic	cat=pert
cosmological	cat=pert
costa rican	cat=pert
costal	cat=pert
covalent	cat=pert
cranial	cat=pert
craniometric	cat=pert
craniometrical	cat=pert
creaseproof	cat=pert
crease-resistant	cat=pert
credal	cat=pert
creedal	cat=pert
creole	cat=pert
cretaceous	cat=pert
cretinous	cat=pert
criminal	cat=pert
criminological	cat=pert
crinoid	cat=pert
critical	cat=pert
croatian	cat=pert
cromwellian	cat=pert
cross-country	cat=pert
cross-cultural	cat=pert
cross-linguistic	cat=pert
cross-modal	cat=pert
cross-ply	cat=pert
cross-pollinating	cat=pert
cross-sectional	cat=pert
cross-sentential	cat=pert
croupy	cat=pert
cruciferous	cat=pert
crural	cat=pert
crustacean	cat=pert
crustaceous	cat=pert
crustose	cat=pert
cryogenic	cat=pert
cryonic	cat=pert
cryptanalytic	cat=pert
cryptobiotic	cat=pert
cryptogamic	cat=pert
cryptogamous	cat=pert
cryptographic	cat=pert
cryptographical	cat=pert
cryptologic	cat=pert
cryptological	cat=pert
cuban	cat=pert
cubist	cat=pert
cubistic	cat=pert
cubital	cat=pert
cucurbitaceous	cat=pert
culinary	cat=pert
cultural	cat=pert
cuneal	cat=pert
cuneiform	cat=pert
cupric	cat=pert
cuprous	cat=pert
curatorial	cat=pert
curricular	cat=pert
cutaneal	cat=pert
cutaneous	cat=pert
cuticular	cat=pert
cyanobacterial	cat=pert
cyanophyte	cat=pert
cybernetic	cat=pert
cyclic	cat=pert
cyclonal	cat=pert
cyclonic	cat=pert
cyclonical	cat=pert
cyclopean	cat=pert
cyclothymic	cat=pert
cylindric	cat=pert
cylindrical	cat=pert
cyprian	cat=pert
cyprinid	cat=pert
cyprinoid	cat=pert
cypriot	cat=pert
cypriote	cat=pert
cyrillic	cat=pert
cystic	cat=pert
cytoarchitectonic	cat=pert
cytoarchitectural	cat=pert
cytogenetic	cat=pert
cytogenetical	cat=pert
cytokinetic	cat=pert
cytologic	cat=pert
cytological	cat=pert
cytolytic	cat=pert
cytophotometric	cat=pert
cytoplasmatic	cat=pert
cytoplasmic	cat=pert
cytoplastic	cat=pert
cytotoxic	cat=pert
czarist	cat=pert
czaristic	cat=pert
czech	cat=pert
czechoslovakian	cat=pert
dacitic	cat=pert
dactylic	cat=pert
daily	cat=pert
daisylike	cat=pert
dalmatian	cat=pert
damascene	cat=pert
danish	cat=pert
dantean	cat=pert
dantesque	cat=pert
darwinian	cat=pert
declarative	cat=pert
deconstructionist	cat=pert
deductive	cat=pert
deformational	cat=pert
deictic	cat=pert
deiist	cat=pert
deistic	cat=pert
deliverable	cat=pert
delphian	cat=pert
delphic	cat=pert
demagogic	cat=pert
demagogical	cat=pert
democratic	cat=pert
demographic	cat=pert
demosthenic	cat=pert
demotic	cat=pert
dendritic	cat=pert
denominational	cat=pert
dental	cat=pert
departmental	cat=pert
dermal	cat=pert
dermatologic	cat=pert
dermatological	cat=pert
dermic	cat=pert
despotic	cat=pert
despotical	cat=pert
developmental	cat=pert
deweyan	cat=pert
diabetic	cat=pert
diagnostic	cat=pert
diagonalizable	cat=pert
dialectal	cat=pert
dialectic	cat=pert
dialectical	cat=pert
diamagnetic	cat=pert
diamantine	cat=pert
diametral	cat=pert
diametric	cat=pert
diametrical	cat=pert
diaphoretic	cat=pert
diaphyseal	cat=pert
diaphysial	cat=pert
diastolic	cat=pert
diatomic	cat=pert
diazo	cat=pert
dicarboxylic	cat=pert
dichromatic	cat=pert
dickensian	cat=pert
dictatorial	cat=pert
dictyopteran	cat=pert
dietary	cat=pert
dietetic	cat=pert
dietetical	cat=pert
differentiable	cat=pert
differential	cat=pert
digestive	cat=pert
digital	cat=pert
diluvial	cat=pert
diluvian	cat=pert
dimensional	cat=pert
dimorphic	cat=pert
dimorphous	cat=pert
diocesan	cat=pert
dionysian	cat=pert
diplomatic	cat=pert
dipolar	cat=pert
dipterous	cat=pert
dipylon	cat=pert
directional	cat=pert
disciplinary	cat=pert
discomycetous	cat=pert
distributional	cat=pert
dithyrambic	cat=pert
divalent	cat=pert
divisional	cat=pert
dizygotic	cat=pert
dizygous	cat=pert
djiboutian	cat=pert
doctoral	cat=pert
doctorial	cat=pert
doctrinal	cat=pert
documental	cat=pert
documentary	cat=pert
dogmatic	cat=pert
dolomitic	cat=pert
domestic	cat=pert
domiciliary	cat=pert
dominical	cat=pert
dominican	cat=pert
donatist	cat=pert
donnean	cat=pert
donnian	cat=pert
dostoevskian	cat=pert
dostoyevskian	cat=pert
dot-com	cat=pert
draconian	cat=pert
dramatic	cat=pert
dramaturgic	cat=pert
dramaturgical	cat=pert
drupaceous	cat=pert
dualistic	cat=pert
ducal	cat=pert
ductless	cat=pert
duodenal	cat=pert
dural	cat=pert
dutch	cat=pert
dyadic	cat=pert
dynamic	cat=pert
dynastic	cat=pert
dysgenic	cat=pert
dyslexic	cat=pert
dysplastic	cat=pert
dystopian	cat=pert
earthen	cat=pert
east african	cat=pert
east german	cat=pert
east indian	cat=pert
east pakistani	cat=pert
eastern orthodox	cat=pert
ebionite	cat=pert
ebracteate	cat=pert
ecclesiastic	cat=pert
ecclesiastical	cat=pert
ecologic	cat=pert
ecological	cat=pert
econometric	cat=pert
economic	cat=pert
economical	cat=pert
ectodermal	cat=pert
ectodermic	cat=pert
ectopic	cat=pert
ectozoan	cat=pert
ecuadorian	cat=pert
editorial	cat=pert
educational	cat=pert
edwardian	cat=pert
egyptian	cat=pert
einsteinian	cat=pert
electoral	cat=pert
electric	cat=pert
electrical	cat=pert
electrocardiographic	cat=pert
electrochemical	cat=pert
electroencephalographic	cat=pert
electrolytic	cat=pert
electromagnetic	cat=pert
electromechanical	cat=pert
electromotxsive	cat=pert
electron microscopic	cat=pert
electronic	cat=pert
electrophoretic	cat=pert
electrostatic	cat=pert
elegiac	cat=pert
elemental	cat=pert
elfin	cat=pert
elizabethan	cat=pert
elliptic	cat=pert
elliptical	cat=pert
elocutionary	cat=pert
elysian	cat=pert
embolic	cat=pert
embryonal	cat=pert
embryonic	cat=pert
emotional	cat=pert
emphysematous	cat=pert
empiric	cat=pert
empirical	cat=pert
empyreal	cat=pert
empyrean	cat=pert
emulous	cat=pert
encysted	cat=pert
endermatic	cat=pert
endermic	cat=pert
endocrinal	cat=pert
endocrine	cat=pert
endodontic	cat=pert
endogenous	cat=pert
endometrial	cat=pert
endoparasitic	cat=pert
endoscopic	cat=pert
endothelial	cat=pert
endovenous	cat=pert
endozoan	cat=pert
english	cat=pert
enolic	cat=pert
enteral	cat=pert
enteric	cat=pert
entomologic	cat=pert
entomological	cat=pert
entozoan	cat=pert
entrepreneurial	cat=pert
environmental	cat=pert
enzymatic	cat=pert
eolithic	cat=pert
eonian	cat=pert
eosinophilic	cat=pert
eparchial	cat=pert
epenthetic	cat=pert
ephesan	cat=pert
epic	cat=pert
epical	cat=pert
epicarpal	cat=pert
epicurean	cat=pert
epicyclic	cat=pert
epicyclical	cat=pert
epidemiologic	cat=pert
epidemiological	cat=pert
epidermal	cat=pert
epidermic	cat=pert
epidural	cat=pert
epigastric	cat=pert
epileptic	cat=pert
epilithic	cat=pert
epiphyseal	cat=pert
epiphysial	cat=pert
epiphytic	cat=pert
episcopal	cat=pert
episcopalian	cat=pert
epistemic	cat=pert
epistemological	cat=pert
epithelial	cat=pert
epitheliod	cat=pert
epizoan	cat=pert
eponymic	cat=pert
eponymous	cat=pert
equatorial	cat=pert
equestrian	cat=pert
equine	cat=pert
equinoctial	cat=pert
erasmian	cat=pert
eremitic	cat=pert
eremitical	cat=pert
ergonomic	cat=pert
ergotic	cat=pert
ergotropic	cat=pert
eritrean	cat=pert
erythematous	cat=pert
erythroid	cat=pert
erythropoietic	cat=pert
eschatological	cat=pert
esophageal	cat=pert
essene	cat=pert
essential	cat=pert
esthetic	cat=pert
estonian	cat=pert
estrogenic	cat=pert
estuarial	cat=pert
estuarine	cat=pert
ethereal	cat=pert
ethical	cat=pert
ethiopian	cat=pert
ethnocentric	cat=pert
ethnographic	cat=pert
ethnographical	cat=pert
ethnologic	cat=pert
ethnological	cat=pert
etiologic	cat=pert
etiological	cat=pert
etymological	cat=pert
eucaryotic	cat=pert
eucharistic	cat=pert
euclidean	cat=pert
euclidian	cat=pert
eudaemonic	cat=pert
eudemonic	cat=pert
eugenic	cat=pert
eukaryotic	cat=pert
euphonic	cat=pert
euphonical	cat=pert
eurafrican	cat=pert
eurasian	cat=pert
eurasiatic	cat=pert
eurocentric	cat=pert
european	cat=pert
europocentric	cat=pert
eutherian	cat=pert
evangelical	cat=pert
evangelistic	cat=pert
evaporative	cat=pert
even-toed	cat=pert
evidentiary	cat=pert
evolutionary	cat=pert
excrescent	cat=pert
excretory	cat=pert
executive	cat=pert
exegetic	cat=pert
exegetical	cat=pert
exilic	cat=pert
existential	cat=pert
existentialist	cat=pert
exocrine	cat=pert
exodontic	cat=pert
expansionist	cat=pert
experiential	cat=pert
experimental	cat=pert
expiative	cat=pert
expiatory	cat=pert
expiratory	cat=pert
exponential	cat=pert
expressionist	cat=pert
expressionistic	cat=pert
exteroceptive	cat=pert
extracellular	cat=pert
extradural	cat=pert
extragalactic	cat=pert
extralinguistic	cat=pert
extrasystolic	cat=pert
extraterrestrial	cat=pert
extropic	cat=pert
exuvial	cat=pert
fabian	cat=pert
facial	cat=pert
factor analytic	cat=pert
factor analytical	cat=pert
factorial	cat=pert
factual	cat=pert
facultative	cat=pert
falconine	cat=pert
falstaffian	cat=pert
familial	cat=pert
fanged	cat=pert
fascist	cat=pert
fascistic	cat=pert
fatalist	cat=pert
fatalistic	cat=pert
faucal	cat=pert
faustian	cat=pert
febrile	cat=pert
federal	cat=pert
feline	cat=pert
feminist	cat=pert
femoral	cat=pert
fenestral	cat=pert
ferial	cat=pert
ferric	cat=pert
ferromagnetic	cat=pert
ferrous	cat=pert
fetal	cat=pert
feudal	cat=pert
feudalistic	cat=pert
feudatory	cat=pert
feverish	cat=pert
fiberoptic	cat=pert
fiber-optic	cat=pert
fibreoptic	cat=pert
fibre-optic	cat=pert
fibrillose	cat=pert
fibrinous	cat=pert
fibrocalcific	cat=pert
fibrocartilaginous	cat=pert
fictile	cat=pert
fictional	cat=pert
fiducial	cat=pert
fiduciary	cat=pert
fijian	cat=pert
filar	cat=pert
filarial	cat=pert
filariid	cat=pert
filial	cat=pert
filipino	cat=pert
financial	cat=pert
finnish	cat=pert
firmamental	cat=pert
fiscal	cat=pert
fisheye	cat=pert
fistulous	cat=pert
flagellate	cat=pert
flagellated	cat=pert
flemish	cat=pert
fleshy	cat=pert
floral	cat=pert
florentine	cat=pert
floricultural	cat=pert
fluvial	cat=pert
focal	cat=pert
foetal	cat=pert
foliaceous	cat=pert
foliate	cat=pert
foliated	cat=pert
follicular	cat=pert
forcipate	cat=pert
formalised	cat=pert
formalistic	cat=pert
formalized	cat=pert
formative	cat=pert
formic	cat=pert
formosan	cat=pert
formulary	cat=pert
fortnightly	cat=pert
fossil	cat=pert
fossiliferous	cat=pert
fourhanded	cat=pert
four-wheel	cat=pert
four-wheeled	cat=pert
franciscan	cat=pert
frankish	cat=pert
fraternal	cat=pert
french	cat=pert
fretted	cat=pert
freudian	cat=pert
frictional	cat=pert
frictionless	cat=pert
frisian	cat=pert
frontal	cat=pert
frostian	cat=pert
fruticose	cat=pert
fruticulose	cat=pert
fugal	cat=pert
functional	cat=pert
fundamentalist	cat=pert
fundamentalistic	cat=pert
funerary	cat=pert
fungal	cat=pert
fungicidal	cat=pert
fungoid	cat=pert
fungous	cat=pert
funguslike	cat=pert
funicular	cat=pert
future	cat=pert
futurist	cat=pert
futuristic	cat=pert
gabonese	cat=pert
gaelic	cat=pert
galactic	cat=pert
galilaean	cat=pert
galilean	cat=pert
gallic	cat=pert
gallinaceous	cat=pert
galvanic	cat=pert
galwegian	cat=pert
gambian	cat=pert
gandhian	cat=pert
garlicky	cat=pert
gastric	cat=pert
gastroesophageal	cat=pert
gastrointestinal	cat=pert
gastronomic	cat=pert
gastronomical	cat=pert
gauguinesque	cat=pert
gaussian	cat=pert
gemmiferous	cat=pert
genealogic	cat=pert
genealogical	cat=pert
generational	cat=pert
generic	cat=pert
genetic	cat=pert
genetical	cat=pert
genial	cat=pert
genic	cat=pert
genital	cat=pert
genitive	cat=pert
genitourinary	cat=pert
genoese	cat=pert
genotypic	cat=pert
genotypical	cat=pert
genovese	cat=pert
gentile	cat=pert
geodesic	cat=pert
geodesical	cat=pert
geodetic	cat=pert
geographic	cat=pert
geographical	cat=pert
geologic	cat=pert
geological	cat=pert
geometric	cat=pert
geometrical	cat=pert
geomorphologic	cat=pert
geomorphological	cat=pert
geophysical	cat=pert
geophytic	cat=pert
geopolitical	cat=pert
georgian	cat=pert
geostrategic	cat=pert
geothermal	cat=pert
geothermic	cat=pert
geriatric	cat=pert
german	cat=pert
german-american	cat=pert
germanic	cat=pert
gerontological	cat=pert
gerundial	cat=pert
gestational	cat=pert
ghanaian	cat=pert
ghanese	cat=pert
ghanian	cat=pert
gi	cat=pert
gibraltarian	cat=pert
gilbertian	cat=pert
gingival	cat=pert
glacial	cat=pert
gladiatorial	cat=pert
glandular	cat=pert
glaswegian	cat=pert
glial	cat=pert
glomerular	cat=pert
glossopharyngeal	cat=pert
glottal	cat=pert
glottochronological	cat=pert
gluteal	cat=pert
glycogenic	cat=pert
gnomic	cat=pert
gnostic	cat=pert
goethean	cat=pert
goethian	cat=pert
gonadal	cat=pert
gonadotrophic	cat=pert
gonadotropic	cat=pert
gothic	cat=pert
governmental	cat=pert
graecophile	cat=pert
graecophilic	cat=pert
grammatic	cat=pert
grammatical	cat=pert
granuliferous	cat=pert
granulocytic	cat=pert
granulomatous	cat=pert
grapelike	cat=pert
graphic	cat=pert
graphical	cat=pert
gravimetric	cat=pert
gravitational	cat=pert
gravitative	cat=pert
grecian	cat=pert
greek	cat=pert
greek orthodox	cat=pert
green	cat=pert
greenhouse	cat=pert
greenside	cat=pert
gregorian	cat=pert
grenadian	cat=pert
growing	cat=pert
gu	cat=pert
guatemalan	cat=pert
gubernatorial	cat=pert
guinean	cat=pert
gustative	cat=pert
gustatorial	cat=pert
gustatory	cat=pert
guttural	cat=pert
guyanese	cat=pert
gymnastic	cat=pert
gymnosophical	cat=pert
gymnospermous	cat=pert
gynaecological	cat=pert
gynecologic	cat=pert
gynecological	cat=pert
gyral	cat=pert
gyroscopic	cat=pert
hadal	cat=pert
haemal	cat=pert
haematal	cat=pert
haematic	cat=pert
haematogenic	cat=pert
haematological	cat=pert
haematopoietic	cat=pert
haemic	cat=pert
haemolytic	cat=pert
haemophilic	cat=pert
haemopoietic	cat=pert
haemorrhagic	cat=pert
hair-shirt	cat=pert
hair-shirted	cat=pert
haitian	cat=pert
half-hourly	cat=pert
handelian	cat=pert
hanoverian	cat=pert
haptic	cat=pert
harmonic	cat=pert
hasidic	cat=pert
hassidic	cat=pert
hawaiian	cat=pert
heathlike	cat=pert
heavenly	cat=pert
hebdomadal	cat=pert
hebdomadary	cat=pert
hebraic	cat=pert
hebraical	cat=pert
hebrew	cat=pert
hebridean	cat=pert
hegelian	cat=pert
heliac	cat=pert
heliacal	cat=pert
hellenic	cat=pert
hellenistic	cat=pert
hellenistical	cat=pert
hemal	cat=pert
hematal	cat=pert
hematic	cat=pert
hematogenic	cat=pert
hematologic	cat=pert
hematological	cat=pert
hematopoietic	cat=pert
hemic	cat=pert
hemingwayesque	cat=pert
hemiparasitic	cat=pert
hemispheric	cat=pert
hemispherical	cat=pert
hemolytic	cat=pert
hemophilic	cat=pert
hemopoietic	cat=pert
hemorrhagic	cat=pert
hepatic	cat=pert
heraldic	cat=pert
heraldist	cat=pert
herbal	cat=pert
hermeneutic	cat=pert
heroic	cat=pert
hertzian	cat=pert
heterodyne	cat=pert
heterosporous	cat=pert
heterotrophic	cat=pert
hex	cat=pert
hexadecimal	cat=pert
hexagonal	cat=pert
hexangular	cat=pert
hidrotic	cat=pert
hieratic	cat=pert
hieratical	cat=pert
hieroglyphic	cat=pert
hieroglyphical	cat=pert
high-energy	cat=pert
hilar	cat=pert
himalayan	cat=pert
hindi	cat=pert
hindoo	cat=pert
hindu	cat=pert
hindustani	cat=pert
hiplength	cat=pert
hip-length	cat=pert
hippocratic	cat=pert
hircine	cat=pert
hispanic	cat=pert
hispaniolan	cat=pert
histologic	cat=pert
histological	cat=pert
historical	cat=pert
hitlerian	cat=pert
hittite	cat=pert
hollywood	cat=pert
holographic	cat=pert
holographical	cat=pert
home	cat=pert
homeopathic	cat=pert
homeostatic	cat=pert
homeric	cat=pert
homiletic	cat=pert
homiletical	cat=pert
homophonous	cat=pert
homosporous	cat=pert
homostylic	cat=pert
homostylous	cat=pert
honduran	cat=pert
honostyled	cat=pert
hooflike	cat=pert
horary	cat=pert
hormonal	cat=pert
horse-drawn	cat=pert
horticultural	cat=pert
hourly	cat=pert
hugoesque	cat=pert
human	cat=pert
humane	cat=pert
humanist	cat=pert
humanistic	cat=pert
humanitarian	cat=pert
humic	cat=pert
humified	cat=pert
humoral	cat=pert
hungarian	cat=pert
huxleian	cat=pert
huxleyan	cat=pert
hyaloplasmic	cat=pert
hydraulic	cat=pert
hydrocephalic	cat=pert
hydrodynamic	cat=pert
hydroelectric	cat=pert
hydrographic	cat=pert
hydrographical	cat=pert
hydrokinetic	cat=pert
hydrolyzable	cat=pert
hydrometric	cat=pert
hydropathic	cat=pert
hydroponic	cat=pert
hydrostatic	cat=pert
hydroxy	cat=pert
hymenal	cat=pert
hymeneal	cat=pert
hymenopterous	cat=pert
hyoid	cat=pert
hyperbolic	cat=pert
hyperemic	cat=pert
hyperthermal	cat=pert
hypodermal	cat=pert
hypodermic	cat=pert
hypoglycaemic	cat=pert
hypoglycemic	cat=pert
hypophyseal	cat=pert
hypophysial	cat=pert
hypothalamic	cat=pert
hypothermic	cat=pert
hypovolaemic	cat=pert
hypovolemic	cat=pert
iambic	cat=pert
iberian	cat=pert
ibsenian	cat=pert
icelandic	cat=pert
ichorous	cat=pert
iconic	cat=pert
icosahedral	cat=pert
ictal	cat=pert
icterogenic	cat=pert
ictic	cat=pert
ideal	cat=pert
idealistic	cat=pert
ideographic	cat=pert
idiomatic	cat=pert
idiomatical	cat=pert
idiopathic	cat=pert
idolatrous	cat=pert
igneous	cat=pert
iliac	cat=pert
illative	cat=pert
immune	cat=pert
immunochemical	cat=pert
immunocompromised	cat=pert
immunologic	cat=pert
immunological	cat=pert
immunosuppressed	cat=pert
immunosuppressive	cat=pert
immunotherapeutic	cat=pert
imperative	cat=pert
imperial	cat=pert
imperialist	cat=pert
imperialistic	cat=pert
impetiginous	cat=pert
impressionist	cat=pert
impressionistic	cat=pert
incendiary	cat=pert
incestuous	cat=pert
incident	cat=pert
indexical	cat=pert
indexless	cat=pert
indian	cat=pert
indicative	cat=pert
indo-aryan	cat=pert
indo-european	cat=pert
indo-germanic	cat=pert
indonesian	cat=pert
inductive	cat=pert
indusial	cat=pert
industrial	cat=pert
inertial	cat=pert
infantile	cat=pert
infectious	cat=pert
inferential	cat=pert
infernal	cat=pert
infinitival	cat=pert
infinitive	cat=pert
inframaxillary	cat=pert
inguinal	cat=pert
inhalant	cat=pert
ink-jet	cat=pert
inquisitorial	cat=pert
insectan	cat=pert
inspiratory	cat=pert
institutional	cat=pert
instructional	cat=pert
instrumental	cat=pert
insular	cat=pert
insurrectional	cat=pert
insurrectionary	cat=pert
integumental	cat=pert
integumentary	cat=pert
intellectual	cat=pert
intensive	cat=pert
intercellular	cat=pert
intercostal	cat=pert
interdepartmental	cat=pert
interdisciplinary	cat=pert
interest-bearing	cat=pert
interfacial	cat=pert
intergalactic	cat=pert
interlineal	cat=pert
interlinear	cat=pert
interlobular	cat=pert
interlocutory	cat=pert
intermolecular	cat=pert
interoceptive	cat=pert
interplanetary	cat=pert
interrogative	cat=pert
interstellar	cat=pert
interstitial	cat=pert
intertidal	cat=pert
intertribal	cat=pert
intervertebral	cat=pert
intestinal	cat=pert
intimal	cat=pert
intracellular	cat=pert
intracerebral	cat=pert
intracranial	cat=pert
intracutaneous	cat=pert
intradepartmental	cat=pert
intradermal	cat=pert
intradermic	cat=pert
intralinguistic	cat=pert
intralobular	cat=pert
intramolecular	cat=pert
intramuscular	cat=pert
intrapulmonary	cat=pert
intrasentential	cat=pert
intrauterine	cat=pert
intravenous	cat=pert
intraventricular	cat=pert
intuitionist	cat=pert
involucrate	cat=pert
iodinated	cat=pert
iodised	cat=pert
iodized	cat=pert
ionic	cat=pert
iraki	cat=pert
iranian	cat=pert
iraqi	cat=pert
iridaceous	cat=pert
iridic	cat=pert
irish	cat=pert
iritic	cat=pert
irrational	cat=pert
ischaemic	cat=pert
ischemic	cat=pert
isentropic	cat=pert
islamic	cat=pert
ismaili	cat=pert
isolationist	cat=pert
isolationistic	cat=pert
isomeric	cat=pert
isometric	cat=pert
isomorphic	cat=pert
isomorphous	cat=pert
isopteran	cat=pert
isothermic	cat=pert
isotonic	cat=pert
isotopic	cat=pert
israeli	cat=pert
isthmian	cat=pert
italian	cat=pert
italic	cat=pert
jacksonian	cat=pert
jacobean	cat=pert
jacobinic	cat=pert
jacobinical	cat=pert
jain	cat=pert
jainist	cat=pert
jamaican	cat=pert
japanese	cat=pert
javan	cat=pert
javanese	cat=pert
jawless	cat=pert
jeffersonian	cat=pert
jesuit	cat=pert
jesuitic	cat=pert
jesuitical	cat=pert
jet-propelled	cat=pert
jewish	cat=pert
jewish-orthodox	cat=pert
jihadi	cat=pert
jordanian	cat=pert
journalistic	cat=pert
jovian	cat=pert
judaic	cat=pert
judaical	cat=pert
judeo-christian	cat=pert
judicial	cat=pert
jugular	cat=pert
julian	cat=pert
jumentous	cat=pert
jungian	cat=pert
juridic	cat=pert
juridical	cat=pert
jurisprudential	cat=pert
juvenile	cat=pert
kafkaesque	cat=pert
kampuchean	cat=pert
kantian	cat=pert
karyokinetic	cat=pert
kashmiri	cat=pert
katabolic	cat=pert
katari	cat=pert
katharobic	cat=pert
kazakhstani	cat=pert
kechuan	cat=pert
keeled	cat=pert
kenyan	cat=pert
keynesian	cat=pert
kinaesthetic	cat=pert
kinesthetic	cat=pert
kinetic	cat=pert
kiplingesque	cat=pert
knee-length	cat=pert
kokka	cat=pert
koranic	cat=pert
korean	cat=pert
kurdish	cat=pert
kuwaiti	cat=pert
kyrgyzstani	cat=pert
labial	cat=pert
labyrinthine	cat=pert
lacertilian	cat=pert
lachrymal	cat=pert
lachrymatory	cat=pert
lacrimal	cat=pert
lacrimatory	cat=pert
lacteal	cat=pert
lactic	cat=pert
lactogenic	cat=pert
lacustrine	cat=pert
lamarckian	cat=pert
lamaze	cat=pert
lancastrian	cat=pert
laniary	cat=pert
lao	cat=pert
laotian	cat=pert
lapidary	cat=pert
laputan	cat=pert
large-cap	cat=pert
large-capitalisation	cat=pert
large-capitalization	cat=pert
larval	cat=pert
laryngeal	cat=pert
laryngopharyngeal	cat=pert
lathery	cat=pert
latin	cat=pert
latin-american	cat=pert
latinate	cat=pert
latino	cat=pert
latitudinal	cat=pert
latvian	cat=pert
lebanese	cat=pert
legal	cat=pert
legislative	cat=pert
leguminious	cat=pert
leguminous	cat=pert
leibnitzian	cat=pert
leibnizian	cat=pert
lenten	cat=pert
leonardesque	cat=pert
leonine	cat=pert
leprous	cat=pert
levantine	cat=pert
levitical	cat=pert
lexical	cat=pert
lexicalised	cat=pert
lexicalized	cat=pert
lexicographic	cat=pert
lexicographical	cat=pert
lexicostatistic	cat=pert
liberian	cat=pert
libidinal	cat=pert
libyan	cat=pert
liechtensteiner	cat=pert
lienal	cat=pert
life-support	cat=pert
liliaceous	cat=pert
lilliputian	cat=pert
limacine	cat=pert
limacoid	cat=pert
limbic	cat=pert
limnological	cat=pert
lincolnesque	cat=pert
lincolnian	cat=pert
lingual	cat=pert
linguistic	cat=pert
linnaean	cat=pert
linnean	cat=pert
literary	cat=pert
lithic	cat=pert
lithographic	cat=pert
lithomantic	cat=pert
lithophytic	cat=pert
lithuanian	cat=pert
litigious	cat=pert
littoral	cat=pert
liturgical	cat=pert
liverpudlian	cat=pert
living	cat=pert
lobar	cat=pert
lobate	cat=pert
lobated	cat=pert
lobeliaceous	cat=pert
lobular	cat=pert
local	cat=pert
locker-room	cat=pert
locomotive	cat=pert
locomotor	cat=pert
logarithmic	cat=pert
logistic	cat=pert
logistical	cat=pert
logogrammatic	cat=pert
logographic	cat=pert
longitudinal	cat=pert
lucifugal	cat=pert
lucifugous	cat=pert
lumbar	cat=pert
lumbosacral	cat=pert
lunar	cat=pert
lunisolar	cat=pert
lupine	cat=pert
lusitanian	cat=pert
luteal	cat=pert
lutheran	cat=pert
luxembourgian	cat=pert
luxemburger	cat=pert
lymphatic	cat=pert
lymphocytic	cat=pert
lymphoid	cat=pert
lyric	cat=pert
lysogenic	cat=pert
macaronic	cat=pert
macedonian	cat=pert
macerative	cat=pert
machiavellian	cat=pert
machine readable	cat=pert
macrencephalic	cat=pert
macrencephalous	cat=pert
macrobiotic	cat=pert
macrocephalic	cat=pert
macrocephalous	cat=pert
macrocosmic	cat=pert
macroeconomic	cat=pert
macromolecular	cat=pert
madagascan	cat=pert
magisterial	cat=pert
magnetic	cat=pert
magyar	cat=pert
malarial	cat=pert
malawian	cat=pert
malay	cat=pert
malayan	cat=pert
malayo-polynesian	cat=pert
malaysian	cat=pert
malian	cat=pert
maltese	cat=pert
malthusian	cat=pert
mammalian	cat=pert
mammary	cat=pert
managerial	cat=pert
manchurian	cat=pert
mancunian	cat=pert
mandaean	cat=pert
mandean	cat=pert
mandibular	cat=pert
mandibulate	cat=pert
mandibulofacial	cat=pert
manichaean	cat=pert
manichean	cat=pert
manichee	cat=pert
manorial	cat=pert
manual	cat=pert
manx	cat=pert
maoist	cat=pert
marian	cat=pert
marine	cat=pert
marital	cat=pert
maritime	cat=pert
markovian	cat=pert
marly	cat=pert
maroc	cat=pert
married	cat=pert
marsupial	cat=pert
martian	cat=pert
marxist	cat=pert
marxist-leninist	cat=pert
masonic	cat=pert
masoretic	cat=pert
mass spectroscopic	cat=pert
mass-spectrometric	cat=pert
masted	cat=pert
mastoid	cat=pert
mastoidal	cat=pert
maternal	cat=pert
mathematical	cat=pert
matrimonial	cat=pert
maturational	cat=pert
mauritanian	cat=pert
mauritian	cat=pert
maxillary	cat=pert
maxillodental	cat=pert
maxillofacial	cat=pert
maxillomandibular	cat=pert
mayoral	cat=pert
mechanical	cat=pert
mechanically skillful	cat=pert
mechanistic	cat=pert
mecopterous	cat=pert
mediaeval	cat=pert
mediatorial	cat=pert
mediatory	cat=pert
medical	cat=pert
medicolegal	cat=pert
medieval	cat=pert
mediterranean	cat=pert
medullary	cat=pert
medullated	cat=pert
medusoid	cat=pert
megakaryocytic	cat=pert
megalithic	cat=pert
megaloblastic	cat=pert
meiotic	cat=pert
melodic	cat=pert
membranous	cat=pert
mendelian	cat=pert
meningeal	cat=pert
menopausal	cat=pert
mensal	cat=pert
menstrual	cat=pert
mensural	cat=pert
mental	cat=pert
mentholated	cat=pert
mercantile	cat=pert
mercurial	cat=pert
mercuric	cat=pert
mercurous	cat=pert
meretricious	cat=pert
meridian	cat=pert
meridional	cat=pert
meritocratic	cat=pert
merovingian	cat=pert
mesenteric	cat=pert
mesic	cat=pert
mesoamerican	cat=pert
mesoblastic	cat=pert
mesodermal	cat=pert
mesolithic	cat=pert
mesonic	cat=pert
messianic	cat=pert
metabolic	cat=pert
metacarpal	cat=pert
metacentric	cat=pert
metallurgic	cat=pert
metallurgical	cat=pert
metamorphic	cat=pert
metamorphous	cat=pert
metaphysical	cat=pert
metastable	cat=pert
metastatic	cat=pert
metatarsal	cat=pert
meteoric	cat=pert
meteoritic	cat=pert
meteoritical	cat=pert
meteorologic	cat=pert
meteorological	cat=pert
methodist	cat=pert
methodological	cat=pert
methylated	cat=pert
metric	cat=pert
metrical	cat=pert
metrological	cat=pert
metropolitan	cat=pert
mexican	cat=pert
michelangelesque	cat=pert
microbial	cat=pert
microbic	cat=pert
microcephalic	cat=pert
microcephalous	cat=pert
microcosmic	cat=pert
microeconomic	cat=pert
microelectronic	cat=pert
micrometeoric	cat=pert
micrometeoritic	cat=pert
micropylar	cat=pert
microscopic	cat=pert
microscopical	cat=pert
microsomal	cat=pert
middle eastern	cat=pert
midweek	cat=pert
midweekly	cat=pert
migrational	cat=pert
milanese	cat=pert
milch	cat=pert
military	cat=pert
millenarian	cat=pert
millenary	cat=pert
millennial	cat=pert
millennian	cat=pert
mineral	cat=pert
minimalist	cat=pert
ministerial	cat=pert
minoan	cat=pert
miotic	cat=pert
mishnaic	cat=pert
mithraic	cat=pert
mithraistic	cat=pert
mitral	cat=pert
mnemonic	cat=pert
mnemotechnic	cat=pert
mnemotechnical	cat=pert
modal	cat=pert
modernist	cat=pert
mohammedan	cat=pert
molal	cat=pert
molar	cat=pert
moldovan	cat=pert
molecular	cat=pert
monacan	cat=pert
monarchal	cat=pert
monarchial	cat=pert
monarchic	cat=pert
monarchical	cat=pert
monatomic	cat=pert
monegasque	cat=pert
moneran	cat=pert
monetary	cat=pert
mongol	cat=pert
mongolian	cat=pert
mongoloid	cat=pert
monistic	cat=pert
monoatomic	cat=pert
monocarboxylic	cat=pert
monocarpic	cat=pert
monochromatic	cat=pert
monoclonal	cat=pert
monometallic	cat=pert
monomorphemic	cat=pert
monophysite	cat=pert
monophysitic	cat=pert
monotypic	cat=pert
monozygotic	cat=pert
montane	cat=pert
monthly	cat=pert
montserratian	cat=pert
monumental	cat=pert
moorish	cat=pert
moraceous	cat=pert
moral	cat=pert
morbilliform	cat=pert
moreen	cat=pert
moresque	cat=pert
mormon	cat=pert
moroccan	cat=pert
morphemic	cat=pert
morphologic	cat=pert
morphological	cat=pert
morphophonemic	cat=pert
mortuary	cat=pert
mosaic	cat=pert
moslem	cat=pert
most-favored-nation	cat=pert
motional	cat=pert
motivational	cat=pert
mozambican	cat=pert
mozartean	cat=pert
mozartian	cat=pert
muciferous	cat=pert
mucinoid	cat=pert
mucinous	cat=pert
mucocutaneous	cat=pert
mucoid	cat=pert
mucoidal	cat=pert
mucopurulent	cat=pert
mucosal	cat=pert
mucose	cat=pert
mucous	cat=pert
muhammadan	cat=pert
multicultural	cat=pert
multilevel	cat=pert
multinomial	cat=pert
multinucleate	cat=pert
multiphase	cat=pert
municipal	cat=pert
mural	cat=pert
murine	cat=pert
muscovite	cat=pert
muscular	cat=pert
musculoskeletal	cat=pert
musical	cat=pert
musicological	cat=pert
muslim	cat=pert
mutafacient	cat=pert
mutagenic	cat=pert
mutant	cat=pert
mutational	cat=pert
mutative	cat=pert
muzzle-loading	cat=pert
myalgic	cat=pert
mycenaean	cat=pert
myelic	cat=pert
myelinated	cat=pert
myelinic	cat=pert
myeloid	cat=pert
myocardial	cat=pert
myoid	cat=pert
myopathic	cat=pert
myotic	cat=pert
myotonic	cat=pert
myrmecophytic	cat=pert
mystic	cat=pert
mystical	cat=pert
mythic	cat=pert
mythological	cat=pert
nacreous	cat=pert
namibian	cat=pert
nanocephalic	cat=pert
napoleonic	cat=pert
narcoleptic	cat=pert
narcotic	cat=pert
narial	cat=pert
nasal	cat=pert
nasopharyngeal	cat=pert
natal	cat=pert
national	cat=pert
national socialist	cat=pert
native american	cat=pert
nativist	cat=pert
nativistic	cat=pert
natriuretic	cat=pert
naturistic	cat=pert
nauruan	cat=pert
nautical	cat=pert
naval	cat=pert
navigational	cat=pert
nazarene	cat=pert
nazi	cat=pert
neandertal	cat=pert
neanderthal	cat=pert
neanderthalian	cat=pert
neapolitan	cat=pert
nebular	cat=pert
necromantic	cat=pert
necromantical	cat=pert
necrotic	cat=pert
nectariferous	cat=pert
neoclassicist	cat=pert
neoclassicistic	cat=pert
neocortical	cat=pert
neo-darwinian	cat=pert
neo-lamarckian	cat=pert
neolithic	cat=pert
neonatal	cat=pert
neoplastic	cat=pert
neotenic	cat=pert
neotenous	cat=pert
nepalese	cat=pert
nepali	cat=pert
nephritic	cat=pert
neritic	cat=pert
nervous	cat=pert
nestorian	cat=pert
neural	cat=pert
neuralgic	cat=pert
neurasthenic	cat=pert
neuroanatomic	cat=pert
neuroanatomical	cat=pert
neurobiological	cat=pert
neuroendocrine	cat=pert
neurogenic	cat=pert
neuroglial	cat=pert
neurologic	cat=pert
neurological	cat=pert
neuromatous	cat=pert
neuromuscular	cat=pert
neuronal	cat=pert
neuronic	cat=pert
neurophysiological	cat=pert
neuropsychiatric	cat=pert
neuropsychological	cat=pert
neurotic	cat=pert
neurotoxic	cat=pert
neurotropic	cat=pert
new caledonian	cat=pert
new world	cat=pert
new zealander	cat=pert
newtonian	cat=pert
nicaean	cat=pert
nicaraguan	cat=pert
nicene	cat=pert
nigerian	cat=pert
nigerien	cat=pert
nihilistic	cat=pert
nilotic	cat=pert
nilpotent	cat=pert
nipponese	cat=pert
nitric	cat=pert
nitrogenous	cat=pert
nitrous	cat=pert
nocturnal	cat=pert
nodular	cat=pert
nominal	cat=pert
nominalistic	cat=pert
nominative	cat=pert
noncaloric	cat=pert
nonenzymatic	cat=pert
nonfictional	cat=pert
nonfinancial	cat=pert
nonharmonic	cat=pert
nonionic	cat=pert
nonlexical	cat=pert
nonlinguistic	cat=pert
nonparametric	cat=pert
nonpasserine	cat=pert
nonphotosynthetic	cat=pert
nonpolar	cat=pert
nonruminant	cat=pert
nonspatial	cat=pert
nonspherical	cat=pert
nonsteroidal	cat=pert
nonsuppurative	cat=pert
nonsurgical	cat=pert
nonthermal	cat=pert
nontranslational	cat=pert
nordic	cat=pert
norman	cat=pert
normative	cat=pert
norse	cat=pert
north african	cat=pert
north american	cat=pert
north korean	cat=pert
north vietnamese	cat=pert
norwegian	cat=pert
nosocomial	cat=pert
notional	cat=pert
nuclear	cat=pert
nucleate	cat=pert
nucleated	cat=pert
numeral	cat=pert
numeric	cat=pert
numerical	cat=pert
numerological	cat=pert
numidian	cat=pert
numinous	cat=pert
nuptial	cat=pert
nutritional	cat=pert
nutritionary	cat=pert
oaten	cat=pert
objective	cat=pert
obligational	cat=pert
obstetric	cat=pert
obstetrical	cat=pert
occipital	cat=pert
occlusive	cat=pert
occupational	cat=pert
oceanic	cat=pert
ocellated	cat=pert
octagonal	cat=pert
octal	cat=pert
octangular	cat=pert
ocular	cat=pert
official	cat=pert
ohmic	cat=pert
old world	cat=pert
oleaceous	cat=pert
olfactive	cat=pert
olfactory	cat=pert
oligarchic	cat=pert
oligarchical	cat=pert
olmec	cat=pert
olympian	cat=pert
olympic	cat=pert
omani	cat=pert
omissive	cat=pert
omnidirectional	cat=pert
oncologic	cat=pert
oncological	cat=pert
oneiric	cat=pert
onomastic	cat=pert
onomatopoeic	cat=pert
onomatopoetic	cat=pert
on-the-job	cat=pert
ontogenetic	cat=pert
ontological	cat=pert
open-source	cat=pert
operatic	cat=pert
operational	cat=pert
operationalist	cat=pert
operative	cat=pert
operculate	cat=pert
operculated	cat=pert
ophthalmic	cat=pert
optative	cat=pert
opthalmic	cat=pert
optic	cat=pert
optical	cat=pert
oracular	cat=pert
oral	cat=pert
orbital	cat=pert
orchestral	cat=pert
orchestrated	cat=pert
ordinal	cat=pert
organic	cat=pert
organicistic	cat=pert
organismal	cat=pert
organismic	cat=pert
organizational	cat=pert
ornithological	cat=pert
oropharyngeal	cat=pert
orphic	cat=pert
orthodontic	cat=pert
orthodox	cat=pert
orthographic	cat=pert
orthopaedic	cat=pert
orthopedic	cat=pert
orthopedical	cat=pert
orthoptic	cat=pert
orwellian	cat=pert
oscine	cat=pert
osmotic	cat=pert
osseous	cat=pert
ossicular	cat=pert
ossiculate	cat=pert
ossiferous	cat=pert
osteal	cat=pert
otic	cat=pert
ottoman	cat=pert
outdoor	cat=pert
ovarian	cat=pert
ovine	cat=pert
ovular	cat=pert
oxonian	cat=pert
pachydermal	cat=pert
pachydermatous	cat=pert
pachydermic	cat=pert
pachydermous	cat=pert
pacific	cat=pert
paediatric	cat=pert
pakistani	cat=pert
palaeolithic	cat=pert
palaeontological	cat=pert
palatal	cat=pert
palatial	cat=pert
palatine	cat=pert
palatoglossal	cat=pert
paleoanthropological	cat=pert
paleocortical	cat=pert
paleolithic	cat=pert
paleontological	cat=pert
palestinian	cat=pert
palingenetic	cat=pert
palladian	cat=pert
palmar	cat=pert
palpatory	cat=pert
palpebrate	cat=pert
panamanian	cat=pert
pancreatic	cat=pert
panhellenic	cat=pert
pan-hellenic	cat=pert
panicled	cat=pert
paniculate	cat=pert
pantheist	cat=pert
pantheistic	cat=pert
papal	cat=pert
paperlike	cat=pert
papery	cat=pert
papillary	cat=pert
papillate	cat=pert
papilliform	cat=pert
papillose	cat=pert
papist	cat=pert
papistic	cat=pert
papistical	cat=pert
papuan	cat=pert
parabolic	cat=pert
parabolical	cat=pert
paradigmatic	cat=pert
paraguayan	cat=pert
paralytic	cat=pert
paralytical	cat=pert
paramagnetic	cat=pert
paramedical	cat=pert
parametric	cat=pert
paramilitary	cat=pert
paranasal	cat=pert
parasitic	cat=pert
parasitical	cat=pert
parasympathetic	cat=pert
parasympathomimetic	cat=pert
parental	cat=pert
parenteral	cat=pert
parenthetic	cat=pert
parenthetical	cat=pert
parheliacal	cat=pert
parhelic	cat=pert
parietal	cat=pert
parisian	cat=pert
parliamentary	cat=pert
parochial	cat=pert
parotid	cat=pert
parous	cat=pert
paroxysmal	cat=pert
parthian	cat=pert
participial	cat=pert
particularistic	cat=pert
partitive	cat=pert
parturient	cat=pert
paschal	cat=pert
passerine	cat=pert
past	cat=pert
pasteurian	cat=pert
pastoral	cat=pert
patellar	cat=pert
paternal	cat=pert
pathologic	cat=pert
pathological	cat=pert
patristic	cat=pert
patristical	cat=pert
patronymic	cat=pert
pauline	cat=pert
pavlovian	cat=pert
peacekeeping	cat=pert
peaty	cat=pert
pectic	cat=pert
pectineal	cat=pert
pectoral	cat=pert
pecuniary	cat=pert
pedagogic	cat=pert
pedagogical	cat=pert
pedal	cat=pert
pediatric	cat=pert
pelagic	cat=pert
peloponnesian	cat=pert
pelvic	cat=pert
pemphigous	cat=pert
penal	cat=pert
penial	cat=pert
penicillin-resistant	cat=pert
penile	cat=pert
peninsular	cat=pert
penitential	cat=pert
pentagonal	cat=pert
pentangular	cat=pert
pentatonic	cat=pert
pentavalent	cat=pert
pentecostal	cat=pert
penumbral	cat=pert
peptic	cat=pert
perceptive	cat=pert
perceptual	cat=pert
percussive	cat=pert
percutaneous	cat=pert
perianal	cat=pert
pericardiac	cat=pert
pericardial	cat=pert
perigonal	cat=pert
perinasal	cat=pert
perineal	cat=pert
periodontal	cat=pert
periodontic	cat=pert
perirhinal	cat=pert
perithelial	cat=pert
peritoneal	cat=pert
peroneal	cat=pert
persian	cat=pert
personal	cat=pert
peruvian	cat=pert
petaloid	cat=pert
phagocytic	cat=pert
phalangeal	cat=pert
phallic	cat=pert
pharaonic	cat=pert
pharmaceutic	cat=pert
pharmaceutical	cat=pert
pharmacologic	cat=pert
pharmacological	cat=pert
pharyngeal	cat=pert
phenomenal	cat=pert
phenotypic	cat=pert
phenotypical	cat=pert
philanthropic	cat=pert
philatelic	cat=pert
philatelical	cat=pert
philharmonic	cat=pert
philhellene	cat=pert
philhellenic	cat=pert
philippine	cat=pert
philistine	cat=pert
philological	cat=pert
philosophic	cat=pert
philosophical	cat=pert
phocine	cat=pert
phonemic	cat=pert
phonetic	cat=pert
phonic	cat=pert
phonogramic	cat=pert
phonologic	cat=pert
phonological	cat=pert
phosphoric	cat=pert
phosphorous	cat=pert
photic	cat=pert
photochemical	cat=pert
photoconductive	cat=pert
photoelectric	cat=pert
photoelectrical	cat=pert
photoemissive	cat=pert
photographic	cat=pert
photomechanical	cat=pert
photometric	cat=pert
photometrical	cat=pert
photosynthetic	cat=pert
photovoltaic	cat=pert
phrasal	cat=pert
phreatic	cat=pert
phrenic	cat=pert
phrenological	cat=pert
phyletic	cat=pert
phyllodial	cat=pert
phylogenetic	cat=pert
physical	cat=pert
physicochemical	cat=pert
physiological	cat=pert
physiotherapeutic	cat=pert
piagetian	cat=pert
pianistic	cat=pert
pictographic	cat=pert
pictorial	cat=pert
pictural	cat=pert
pietistic	cat=pert
pietistical	cat=pert
piezoelectric	cat=pert
pilar	cat=pert
pilosebaceous	cat=pert
pineal	cat=pert
piratical	cat=pert
piscatorial	cat=pert
piscatory	cat=pert
piscine	cat=pert
pituitary	cat=pert
plagioclastic	cat=pert
plane-polarized	cat=pert
planetal	cat=pert
planetary	cat=pert
planktonic	cat=pert
planographic	cat=pert
plantal	cat=pert
plantar	cat=pert
platonic	cat=pert
platonistic	cat=pert
pleochroic	cat=pert
pleomorphic	cat=pert
pleural	cat=pert
plumbaginaceous	cat=pert
plumbic	cat=pert
plumbous	cat=pert
pluralistic	cat=pert
plutocratic	cat=pert
plutocratical	cat=pert
pneumatic	cat=pert
pneumococcal	cat=pert
pneumogastric	cat=pert
pneumonic	cat=pert
poetic	cat=pert
poetical	cat=pert
point-of-sale	cat=pert
polar	cat=pert
polarographic	cat=pert
polemoniaceous	cat=pert
polish	cat=pert
political	cat=pert
politically correct	cat=pert
politically incorrect	cat=pert
polyatomic	cat=pert
polydactyl	cat=pert
polydactylous	cat=pert
polygonal	cat=pert
polyhedral	cat=pert
polymeric	cat=pert
polymorphemic	cat=pert
polymorphic	cat=pert
polymorphous	cat=pert
polynomial	cat=pert
polyphase	cat=pert
polyphonic	cat=pert
polyphonous	cat=pert
pontifical	cat=pert
popish	cat=pert
popliteal	cat=pert
porcine	cat=pert
porphyritic	cat=pert
portuguese	cat=pert
positionable	cat=pert
positional	cat=pert
positive	cat=pert
positivist	cat=pert
positivistic	cat=pert
possessive	cat=pert
postal	cat=pert
postexilic	cat=pert
postganglionic	cat=pert
postictal	cat=pert
postmenopausal	cat=pert
postmillennial	cat=pert
postmodern	cat=pert
postmodernist	cat=pert
postnuptial	cat=pert
postpositive	cat=pert
postulational	cat=pert
postural	cat=pert
pouched	cat=pert
praetorial	cat=pert
praetorian	cat=pert
pragmatic	cat=pert
pragmatical	cat=pert
prakritic	cat=pert
prandial	cat=pert
preanal	cat=pert
precancerous	cat=pert
preclinical	cat=pert
pre-columbian	cat=pert
precordial	cat=pert
predestinarian	cat=pert
prefectural	cat=pert
prehistoric	cat=pert
prelapsarian	cat=pert
premarital	cat=pert
premedical	cat=pert
premenopausal	cat=pert
premenstrual	cat=pert
prenuptial	cat=pert
prepositional	cat=pert
pre-raphaelite	cat=pert
presentational	cat=pert
presidential	cat=pert
presocratic	cat=pert
pressor	cat=pert
presymptomatic	cat=pert
pretorial	cat=pert
pretorian	cat=pert
priestly	cat=pert
prime	cat=pert
primiparous	cat=pert
prismatic	cat=pert
pro-american	cat=pert
probabilistic	cat=pert
procaryotic	cat=pert
procedural	cat=pert
processional	cat=pert
proconsular	cat=pert
prodromal	cat=pert
prodromic	cat=pert
professional	cat=pert
professorial	cat=pert
progestational	cat=pert
prokaryotic	cat=pert
prolusory	cat=pert
promissory	cat=pert
promotional	cat=pert
pronominal	cat=pert
propagandist	cat=pert
propagandistic	cat=pert
propagative	cat=pert
propitiatory	cat=pert
proprioceptive	cat=pert
propulsive	cat=pert
prosodic	cat=pert
prostate	cat=pert
prostatic	cat=pert
prosthetic	cat=pert
prosthodontic	cat=pert
proteinaceous	cat=pert
proteolytic	cat=pert
protestant	cat=pert
protozoal	cat=pert
protozoan	cat=pert
protozoic	cat=pert
protozoological	cat=pert
proustian	cat=pert
proverbial	cat=pert
providential	cat=pert
provincial	cat=pert
prussian	cat=pert
psychiatric	cat=pert
psychiatrical	cat=pert
psychic	cat=pert
psychical	cat=pert
psychoanalytic	cat=pert
psychoanalytical	cat=pert
psycholinguistic	cat=pert
psychological	cat=pert
psychometric	cat=pert
psychomotor	cat=pert
psychopharmacological	cat=pert
psychosexual	cat=pert
psychotherapeutic	cat=pert
pteridological	cat=pert
ptolemaic	cat=pert
pubertal	cat=pert
pubic	cat=pert
pudendal	cat=pert
puerile	cat=pert
puerperal	cat=pert
pugilistic	cat=pert
pulmonary	cat=pert
pulmonic	cat=pert
punic	cat=pert
pupillary	cat=pert
puranic	cat=pert
purgatorial	cat=pert
purging	cat=pert
purifying	cat=pert
puritanical	cat=pert
putrid	cat=pert
pyaemic	cat=pert
pycnotic	cat=pert
pyemic	cat=pert
pyknotic	cat=pert
pyloric	cat=pert
pyogenic	cat=pert
pyrectic	cat=pert
pyrochemical	cat=pert
pyroelectric	cat=pert
pyroelectrical	cat=pert
pyrogallic	cat=pert
pyrogenetic	cat=pert
pyrogenic	cat=pert
pyrogenous	cat=pert
pyrographic	cat=pert
pyroligneous	cat=pert
pyrolignic	cat=pert
pyrolytic	cat=pert
pyrotechnic	cat=pert
pyrotechnical	cat=pert
pyrrhic	cat=pert
pythagorean	cat=pert
qatari	cat=pert
quadrangular	cat=pert
quadraphonic	cat=pert
quadrasonic	cat=pert
quadratic	cat=pert
quadriphonic	cat=pert
quadrisonic	cat=pert
qualitative	cat=pert
quantal	cat=pert
quantitative	cat=pert
quantized	cat=pert
quartan	cat=pert
quarterly	cat=pert
quartzose	cat=pert
quebecois	cat=pert
quechuan	cat=pert
quincentenary	cat=pert
quincentennial	cat=pert
quintessential	cat=pert
r.c.	cat=pert
rabbinic	cat=pert
rabbinical	cat=pert
rabelaisian	cat=pert
rachitic	cat=pert
racial	cat=pert
radial	cat=pert
radial-ply	cat=pert
radical	cat=pert
radio	cat=pert
radiographic	cat=pert
radiological	cat=pert
radiophonic	cat=pert
radiotelephonic	cat=pert
raptorial	cat=pert
rastafarian	cat=pert
rational	cat=pert
rationalist	cat=pert
rationalistic	cat=pert
ratlike	cat=pert
rayless	cat=pert
realistic	cat=pert
real-time	cat=pert
recessional	cat=pert
recessionary	cat=pert
recessive	cat=pert
recoilless	cat=pert
recreational	cat=pert
rectal	cat=pert
rectosigmoid	cat=pert
redemptional	cat=pert
redemptive	cat=pert
redemptory	cat=pert
reductionist	cat=pert
refractile	cat=pert
refractive	cat=pert
refractory-lined	cat=pert
regency	cat=pert
regimental	cat=pert
regional	cat=pert
relativistic	cat=pert
rembrandtesque	cat=pert
renal	cat=pert
rental	cat=pert
reptilian	cat=pert
republican	cat=pert
residential	cat=pert
residual	cat=pert
residuary	cat=pert
resinated	cat=pert
resinlike	cat=pert
resistive	cat=pert
respiratory	cat=pert
responsive	cat=pert
retinal	cat=pert
revenant	cat=pert
reversionary	cat=pert
revivalistic	cat=pert
revolutionary	cat=pert
rhenish	cat=pert
rheologic	cat=pert
rheological	cat=pert
rhetorical	cat=pert
rhinal	cat=pert
rhizoidal	cat=pert
rhizomatous	cat=pert
rhodesian	cat=pert
rhombic	cat=pert
rhomboid	cat=pert
rhomboidal	cat=pert
rickettsial	cat=pert
ridged	cat=pert
riemannian	cat=pert
riparian	cat=pert
ritual	cat=pert
ritualistic	cat=pert
rocket-propelled	cat=pert
rocky mountain	cat=pert
roentgenographic	cat=pert
romaic	cat=pert
roman	cat=pert
roman catholic	cat=pert
romance	cat=pert
romani	cat=pert
romanian	cat=pert
romanist	cat=pert
romansh	cat=pert
romantic	cat=pert
romanticist	cat=pert
romanticistic	cat=pert
romany	cat=pert
romish	cat=pert
rooseveltian	cat=pert
rosaceous	cat=pert
rotary	cat=pert
rotational	cat=pert
rotatory	cat=pert
roumanian	cat=pert
rousseauan	cat=pert
royal	cat=pert
ruandan	cat=pert
rumanian	cat=pert
rumansh	cat=pert
ruminant	cat=pert
runic	cat=pert
rupestral	cat=pert
rupicolous	cat=pert
rural	cat=pert
ruritanian	cat=pert
russian	cat=pert
russian orthodox	cat=pert
rwandan	cat=pert
sabahan	cat=pert
sabbatarian	cat=pert
sabbatic	cat=pert
sabbatical	cat=pert
sacculate	cat=pert
sacculated	cat=pert
sacerdotal	cat=pert
sacral	cat=pert
sacramental	cat=pert
sacrificial	cat=pert
sadducean	cat=pert
sadomasochistic	cat=pert
saharan	cat=pert
salamandriform	cat=pert
salientian	cat=pert
salivary	cat=pert
salvadoran	cat=pert
salvadorean	cat=pert
salvific	cat=pert
samoan	cat=pert
san marinese	cat=pert
sanious	cat=pert
sapiens	cat=pert
saponaceous	cat=pert
sapphirine	cat=pert
saprobic	cat=pert
saprophytic	cat=pert
sarawakian	cat=pert
sarcoid	cat=pert
sarcolemmal	cat=pert
sarcolemmic	cat=pert
sarcolemnous	cat=pert
sarcosomal	cat=pert
sardinian	cat=pert
sartorial	cat=pert
satanic	cat=pert
satyric	cat=pert
satyrical	cat=pert
saudi	cat=pert
saudi-arabian	cat=pert
saurian	cat=pert
saxatile	cat=pert
saxicoline	cat=pert
saxicolous	cat=pert
saxon	cat=pert
scalar	cat=pert
scalene	cat=pert
scalic	cat=pert
scandinavian	cat=pert
scapular	cat=pert
scapulohumeral	cat=pert
scenic	cat=pert
schismatic	cat=pert
schismatical	cat=pert
schizoid	cat=pert
schizophrenic	cat=pert
scholastic	cat=pert
sciatic	cat=pert
scientific	cat=pert
sclerosed	cat=pert
sclerotic	cat=pert
scopal	cat=pert
scorbutic	cat=pert
scotch	cat=pert
scotomatous	cat=pert
scots	cat=pert
scottish	cat=pert
scriptural	cat=pert
scrotal	cat=pert
sculptural	cat=pert
scurfy	cat=pert
scythian	cat=pert
secretarial	cat=pert
secretory	cat=pert
sectarian	cat=pert
sectional	cat=pert
sectorial	cat=pert
sedimentary	cat=pert
seismologic	cat=pert
seismological	cat=pert
self	cat=pert
self-aggrandising	cat=pert
self-aggrandizing	cat=pert
self-limited	cat=pert
self-pollinating	cat=pert
self-service	cat=pert
seljuk	cat=pert
semantic	cat=pert
semestral	cat=pert
semestrial	cat=pert
semiannual	cat=pert
semiautobiographical	cat=pert
semicentenary	cat=pert
semicentennial	cat=pert
semimonthly	cat=pert
seminal	cat=pert
seminiferous	cat=pert
semiotic	cat=pert
semiotical	cat=pert
semite	cat=pert
semiterrestrial	cat=pert
semitic	cat=pert
semitropic	cat=pert
semitropical	cat=pert
semiweekly	cat=pert
senatorial	cat=pert
senecan	cat=pert
senegalese	cat=pert
sensational	cat=pert
sensorimotor	cat=pert
sensorineural	cat=pert
sensory	cat=pert
sentential	cat=pert
sepaline	cat=pert
sepaloid	cat=pert
septal	cat=pert
septate	cat=pert
septic	cat=pert
sepulchral	cat=pert
seraphic	cat=pert
seraphical	cat=pert
serbian	cat=pert
serial	cat=pert
sericultural	cat=pert
serologic	cat=pert
serological	cat=pert
serous	cat=pert
servile	cat=pert
servo	cat=pert
servomechanical	cat=pert
sexagesimal	cat=pert
sex-limited	cat=pert
sex-linked	cat=pert
sexual	cat=pert
seychellois	cat=pert
shakedown	cat=pert
shakespearean	cat=pert
shakespearian	cat=pert
shallow-draft	cat=pert
shallow-draught	cat=pert
shamanist	cat=pert
shamanistic	cat=pert
shambolic	cat=pert
shaped	cat=pert
sharp-pointed	cat=pert
shavian	cat=pert
shelflike	cat=pert
shinto	cat=pert
shintoist	cat=pert
shintoistic	cat=pert
short-handled	cat=pert
short-order	cat=pert
shouldered	cat=pert
shrubby	cat=pert
shuha	cat=pert
siamese	cat=pert
siberian	cat=pert
sicilian	cat=pert
sidearm	cat=pert
sidereal	cat=pert
side-to-side	cat=pert
sierra leonian	cat=pert
sigmoid	cat=pert
sigmoidal	cat=pert
sikh	cat=pert
siliceous	cat=pert
silicious	cat=pert
simian	cat=pert
sinewy	cat=pert
singaporean	cat=pert
singhalese	cat=pert
single-stranded	cat=pert
sinhala	cat=pert
sinhalese	cat=pert
sinitic	cat=pert
siouan	cat=pert
sisyphean	cat=pert
skeletal	cat=pert
skinnerian	cat=pert
slav	cat=pert
slavic	cat=pert
slavonic	cat=pert
slivery	cat=pert
slovakian	cat=pert
slovenian	cat=pert
small-cap	cat=pert
small-capitalisation	cat=pert
small-capitalization	cat=pert
snow-capped	cat=pert
soapy	cat=pert
social	cat=pert
socialist	cat=pert
socialistic	cat=pert
societal	cat=pert
sociobiologic	cat=pert
sociobiological	cat=pert
sociocultural	cat=pert
socioeconomic	cat=pert
sociolinguistic	cat=pert
sociological	cat=pert
sociopathic	cat=pert
socratic	cat=pert
soft-nosed	cat=pert
solanaceous	cat=pert
solar	cat=pert
solomonic	cat=pert
somali	cat=pert
somalian	cat=pert
somatosensory	cat=pert
sophistic	cat=pert
soteriological	cat=pert
sotho	cat=pert
south african	cat=pert
south american	cat=pert
south korean	cat=pert
soviet	cat=pert
spacial	cat=pert
spanish	cat=pert
spartan	cat=pert
spastic	cat=pert
spatial	cat=pert
spatiotemporal	cat=pert
specialistic	cat=pert
specific	cat=pert
spectral	cat=pert
spectrographic	cat=pert
spectrometric	cat=pert
spectroscopic	cat=pert
spectroscopical	cat=pert
spermatic	cat=pert
spermicidal	cat=pert
spermous	cat=pert
spherical	cat=pert
sphingine	cat=pert
spicate	cat=pert
spiderlike	cat=pert
spiderly	cat=pert
spidery	cat=pert
spinal	cat=pert
spiritualist	cat=pert
spiritualistic	cat=pert
splanchnic	cat=pert
splenetic	cat=pert
splenic	cat=pert
splintery	cat=pert
spondaic	cat=pert
sporogenous	cat=pert
sporting	cat=pert
sportive	cat=pert
spousal	cat=pert
spring-loaded	cat=pert
squint-eyed	cat=pert
sri lankan	cat=pert
stagflationary	cat=pert
stainable	cat=pert
stalinist	cat=pert
stannic	cat=pert
stannous	cat=pert
staphylococcal	cat=pert
static	cat=pert
statistical	cat=pert
statuary	cat=pert
statutory	cat=pert
stearic	cat=pert
stellar	cat=pert
stemmatic	cat=pert
stenographic	cat=pert
stenographical	cat=pert
stereoscopic	cat=pert
sternal	cat=pert
sternutatory	cat=pert
steroidal	cat=pert
stigmatic	cat=pert
stipendiary	cat=pert
stoic	cat=pert
stoichiometric	cat=pert
stoloniferous	cat=pert
stomachal	cat=pert
stomachic	cat=pert
stomatal	cat=pert
stomatous	cat=pert
stovepiped	cat=pert
strategic	cat=pert
strategical	cat=pert
stravinskian	cat=pert
stravinskyan	cat=pert
strep	cat=pert
streptococcal	cat=pert
streptococcic	cat=pert
striate	cat=pert
structural	cat=pert
subarctic	cat=pert
subatomic	cat=pert
subclavian	cat=pert
subclinical	cat=pert
subcortical	cat=pert
subcutaneous	cat=pert
subdural	cat=pert
subjunctive	cat=pert
sublingual	cat=pert
sublittoral	cat=pert
sublunar	cat=pert
sublunary	cat=pert
subocular	cat=pert
suborbital	cat=pert
sub-saharan	cat=pert
substantival	cat=pert
subtropic	cat=pert
subtropical	cat=pert
suburban	cat=pert
succinic	cat=pert
suctorial	cat=pert
sudanese	cat=pert
sudorific	cat=pert
sufi	cat=pert
sulcate	cat=pert
sulfuretted	cat=pert
sulfuric	cat=pert
sulfurized	cat=pert
sulphuretted	cat=pert
sulphuric	cat=pert
sumatran	cat=pert
sumerian	cat=pert
superficial	cat=pert
superlunar	cat=pert
superlunary	cat=pert
supernaturalist	cat=pert
supernaturalistic	cat=pert
supervisory	cat=pert
suppurative	cat=pert
supraocular	cat=pert
supraorbital	cat=pert
surficial	cat=pert
surgical	cat=pert
sustainable	cat=pert
sustentacular	cat=pert
swazi	cat=pert
swedish	cat=pert
swiss	cat=pert
syllabic	cat=pert
syllogistic	cat=pert
symbolic	cat=pert
symbolical	cat=pert
sympathetic	cat=pert
sympathomimetic	cat=pert
symphonic	cat=pert
symptomatic	cat=pert
synaesthetic	cat=pert
synaptic	cat=pert
syncretic	cat=pert
syncretical	cat=pert
syncretistic	cat=pert
syncretistical	cat=pert
synergistic	cat=pert
synesthetic	cat=pert
synoptic	cat=pert
synovial	cat=pert
syntactic	cat=pert
syntactical	cat=pert
syntagmatic	cat=pert
syphilitic	cat=pert
syrian	cat=pert
systolic	cat=pert
tactical	cat=pert
tactile	cat=pert
tactual	cat=pert
tahitian	cat=pert
tai	cat=pert
taiwanese	cat=pert
tajikistani	cat=pert
tamil	cat=pert
tangential	cat=pert
tannic	cat=pert
tantric	cat=pert
tantrik	cat=pert
tanzanian	cat=pert
taoist	cat=pert
tarsal	cat=pert
tartaric	cat=pert
tasmanian	cat=pert
taurine	cat=pert
taxonomic	cat=pert
taxonomical	cat=pert
technical	cat=pert
technological	cat=pert
technophilic	cat=pert
technophobic	cat=pert
tectonic	cat=pert
tegular	cat=pert
telegraphic	cat=pert
telemetered	cat=pert
teleological	cat=pert
telephonic	cat=pert
tellurian	cat=pert
telluric	cat=pert
telocentric	cat=pert
temperamental	cat=pert
temporal	cat=pert
tendinous	cat=pert
tensile	cat=pert
tensional	cat=pert
tentacled	cat=pert
tentacular	cat=pert
teratogenic	cat=pert
terminal	cat=pert
terminological	cat=pert
terpsichorean	cat=pert
terrene	cat=pert
terrestrial	cat=pert
territorial	cat=pert
tertian	cat=pert
testaceous	cat=pert
testamentary	cat=pert
testicular	cat=pert
testimonial	cat=pert
tetanic	cat=pert
tetragonal	cat=pert
tetrametric	cat=pert
tetravalent	cat=pert
teutonic	cat=pert
texan	cat=pert
textile	cat=pert
textual	cat=pert
thai	cat=pert
thalamocortical	cat=pert
thalassic	cat=pert
thalloid	cat=pert
thallophytic	cat=pert
theatrical	cat=pert
theist	cat=pert
theistic	cat=pert
theistical	cat=pert
thematic	cat=pert
thenal	cat=pert
thenar	cat=pert
theocratic	cat=pert
theological	cat=pert
theosophical	cat=pert
therapeutic	cat=pert
therapeutical	cat=pert
thermal	cat=pert
thermic	cat=pert
thermionic	cat=pert
thermodynamic	cat=pert
thermodynamical	cat=pert
thermoelectric	cat=pert
thermoelectrical	cat=pert
thermogravimetric	cat=pert
thermohydrometric	cat=pert
thermometric	cat=pert
thermostatic	cat=pert
thespian	cat=pert
thoracic	cat=pert
thoreauvian	cat=pert
threaded	cat=pert
three-wheel	cat=pert
three-wheeled	cat=pert
thyroid	cat=pert
thyroidal	cat=pert
thyrotoxic	cat=pert
tibetan	cat=pert
tibial	cat=pert
tidal	cat=pert
tiered	cat=pert
timorese	cat=pert
titular	cat=pert
titulary	cat=pert
tobagonian	cat=pert
togolese	cat=pert
toll-free	cat=pert
tomentose	cat=pert
tonal	cat=pert
tongan	cat=pert
tonic	cat=pert
tonsorial	cat=pert
topical	cat=pert
topographic	cat=pert
topographical	cat=pert
toroidal	cat=pert
torrential	cat=pert
tortious	cat=pert
totalistic	cat=pert
totalitarian	cat=pert
totemic	cat=pert
totipotent	cat=pert
toxicologic	cat=pert
toxicological	cat=pert
trabecular	cat=pert
trabeculate	cat=pert
tracheal	cat=pert
tractive	cat=pert
tragic	cat=pert
tragicomic	cat=pert
transactinide	cat=pert
transatlantic	cat=pert
transcendental	cat=pert
transcultural	cat=pert
transcutaneous	cat=pert
transdermal	cat=pert
transdermic	cat=pert
transitional	cat=pert
translational	cat=pert
translunar	cat=pert
translunary	cat=pert
transoceanic	cat=pert
transpolar	cat=pert
transuranic	cat=pert
trapezoidal	cat=pert
traumatic	cat=pert
triangulate	cat=pert
tribal	cat=pert
tricentenary	cat=pert
tricentennial	cat=pert
triennial	cat=pert
trigonometric	cat=pert
trihydroxy	cat=pert
trinidadian	cat=pert
triumphal	cat=pert
trivalent	cat=pert
trochaic	cat=pert
trojan	cat=pert
trophic	cat=pert
trophoblastic	cat=pert
trophotropic	cat=pert
tropical	cat=pert
tsarist	cat=pert
tsaristic	cat=pert
tswana	cat=pert
tubal	cat=pert
tubercular	cat=pert
tuberculate	cat=pert
tuberculoid	cat=pert
tuberous	cat=pert
tudor	cat=pert
tunisian	cat=pert
turbinate	cat=pert
turkic	cat=pert
turkish	cat=pert
turkmen	cat=pert
tuscan	cat=pert
tutorial	cat=pert
two-wheel	cat=pert
two-wheeled	cat=pert
tympanic	cat=pert
tympanitic	cat=pert
typographic	cat=pert
typographical	cat=pert
tyrannic	cat=pert
tyrannical	cat=pert
tyrolean	cat=pert
tyrolese	cat=pert
tzarist	cat=pert
ugandan	cat=pert
ukrainian	cat=pert
ulcerative	cat=pert
ulnar	cat=pert
ultramicroscopic	cat=pert
ultramontane	cat=pert
umbellar	cat=pert
umbellate	cat=pert
umbelliferous	cat=pert
umbelliform	cat=pert
umbilical	cat=pert
uncial	cat=pert
undescended	cat=pert
unfretted	cat=pert
ungual	cat=pert
uniate	cat=pert
unicellular	cat=pert
unifilar	cat=pert
uninucleate	cat=pert
uniovular	cat=pert
uniovulate	cat=pert
unitarian	cat=pert
unitary	cat=pert
universalist	cat=pert
universalistic	cat=pert
unmyelinated	cat=pert
unpigmented	cat=pert
unthematic	cat=pert
urban	cat=pert
urceolate	cat=pert
urdu	cat=pert
uremic	cat=pert
urethral	cat=pert
uric	cat=pert
urinary	cat=pert
urogenital	cat=pert
ursine	cat=pert
uruguayan	cat=pert
usufructuary	cat=pert
uterine	cat=pert
utopian	cat=pert
uveal	cat=pert
uveous	cat=pert
uvular	cat=pert
uzbekistani	cat=pert
vacuolate	cat=pert
vacuolated	cat=pert
vagal	cat=pert
vaginal	cat=pert
valedictory	cat=pert
valetudinarian	cat=pert
valved	cat=pert
valvular	cat=pert
varicelliform	cat=pert
variolar	cat=pert
variolic	cat=pert
variolous	cat=pert
vascular	cat=pert
vasomotor	cat=pert
vedic	cat=pert
vegetative	cat=pert
vegetive	cat=pert
vehicular	cat=pert
veinal	cat=pert
velar	cat=pert
venereal	cat=pert
venetian	cat=pert
venezuelan	cat=pert
venous	cat=pert
ventilatory	cat=pert
ventricular	cat=pert
verbal	cat=pert
vertebral	cat=pert
vesical	cat=pert
vesicular	cat=pert
vestal	cat=pert
vestiary	cat=pert
vestibular	cat=pert
vestmental	cat=pert
veterinary	cat=pert
viatical	cat=pert
vibrational	cat=pert
vibrionic	cat=pert
vicarial	cat=pert
vicennial	cat=pert
vice-presidential	cat=pert
viceregal	cat=pert
vicinal	cat=pert
victorian	cat=pert
viennese	cat=pert
vietnamese	cat=pert
vigesimal	cat=pert
vinaceous	cat=pert
vinous	cat=pert
viral	cat=pert
virginal	cat=pert
viricidal	cat=pert
virological	cat=pert
virucidal	cat=pert
visceral	cat=pert
viscometric	cat=pert
viscosimetric	cat=pert
visual	cat=pert
vitiliginous	cat=pert
vitreous	cat=pert
vocal	cat=pert
vocalic	cat=pert
vocational	cat=pert
vocative	cat=pert
volar	cat=pert
volcanic	cat=pert
voltaic	cat=pert
voltarean	cat=pert
voltarian	cat=pert
volumed	cat=pert
volumetric	cat=pert
volumetrical	cat=pert
voyeuristic	cat=pert
voyeuristical	cat=pert
vulpecular	cat=pert
vulpine	cat=pert
vulval	cat=pert
vulvar	cat=pert
wagnerian	cat=pert
washingtonian	cat=pert
waxen	cat=pert
waxy	cat=pert
weatherly	cat=pert
wedge-shaped	cat=pert
weekday	cat=pert
weekly	cat=pert
welsh	cat=pert
wesleyan	cat=pert
west african	cat=pert
wheaten	cat=pert
whiplike	cat=pert
wholemeal	cat=pert
whole-wheat	cat=pert
wide-angle	cat=pert
wideband	cat=pert
wilsonian	cat=pert
wittgensteinian	cat=pert
wolfish	cat=pert
wolflike	cat=pert
woolen	cat=pert
woollen	cat=pert
word-blind	cat=pert
wordsworthian	cat=pert
wrinkleproof	cat=pert
wrinkle-resistant	cat=pert
wysiwyg	cat=pert
xerographic	cat=pert
x-linked	cat=pert
yearly	cat=pert
yeastlike	cat=pert
yeatsian	cat=pert
yemeni	cat=pert
yogic	cat=pert
yogistic	cat=pert
yugoslav	cat=pert
yugoslavian	cat=pert
zairean	cat=pert
zairese	cat=pert
zambian	cat=pert
zapotec	cat=pert
zenithal	cat=pert
zero	cat=pert
zimbabwean	cat=pert
zionist	cat=pert
zodiacal	cat=pert
zoic	cat=pert
zolaesque	cat=pert
zonal	cat=pert
zonary	cat=pert
zoological	cat=pert
zoonotic	cat=pert
zoroastrian	cat=pert
zygomatic	cat=pert
zygotic	cat=pert
zymoid	cat=pert
zymolytic	cat=pert
zymotic	cat=pert
