bestride	group=contiguous_location
blanket	group=contiguous_location
border	group=contiguous_location
bound	group=contiguous_location
bracket	group=contiguous_location
bridge	group=contiguous_location
cap	group=contiguous_location
circle	group=contiguous_location
cloak	group=contiguous_location
contain	group=contiguous_location
cover	group=contiguous_location
edge	group=contiguous_location
encircle	group=contiguous_location
enclose	group=contiguous_location
encompass	group=contiguous_location
engulf	group=contiguous_location
envelop	group=contiguous_location
fence	group=contiguous_location
fill	group=contiguous_location
flank	group=contiguous_location
follow	group=contiguous_location
forgo	group=contiguous_location
frame	group=contiguous_location
head	group=contiguous_location
hug	group=contiguous_location
line	group=contiguous_location
neighbor	group=contiguous_location
overcast	group=contiguous_location
overhang	group=contiguous_location
precede	group=contiguous_location
predate	group=contiguous_location
rim	group=contiguous_location
ring	group=contiguous_location
skirt	group=contiguous_location
span	group=contiguous_location
straddle	group=contiguous_location
support	group=contiguous_location
surmount	group=contiguous_location
surround	group=contiguous_location
top	group=contiguous_location
traverse	group=contiguous_location
underlie	group=contiguous_location
wreathe	group=contiguous_location
enshroud	group=contiguous_location
veil	group=contiguous_location
abut	group=contiguous_location
adjoin	group=contiguous_location
cross	group=contiguous_location
hit	group=contiguous_location
intersect	group=contiguous_location
meet	group=contiguous_location
touch	group=contiguous_location
dominate	group=contiguous_location
reason	group=deduce
reason out	group=deduce
conclude	group=deduce
derive	group=deduce
disprove	group=deduce
infer	group=deduce
deduct	group=deduce
deduce	group=deduce
gather	group=deduce
conceive	group=deduce
prove	group=deduce
rationalize	group=deduce
bend	group=assuming_position
bow	group=assuming_position
crouch	group=assuming_position
flop	group=assuming_position
hang	group=assuming_position
hunch	group=assuming_position
hunch up	group=assuming_position
kneel	group=assuming_position
lean	group=assuming_position
lie	group=assuming_position
lie down	group=assuming_position
perch	group=assuming_position
plop	group=assuming_position
rise	group=assuming_position
sit	group=assuming_position
sit down	group=assuming_position
slouch	group=assuming_position
slump	group=assuming_position
sprawl	group=assuming_position
squat	group=assuming_position
squat down	group=assuming_position
stand	group=assuming_position
stand up	group=assuming_position
stoop	group=assuming_position
straddle	group=assuming_position
branch	group=differ
deviate	group=differ
differ	group=differ
diverge	group=differ
vary	group=differ
analyze	group=assessment
appraise	group=assessment
assess	group=assessment
audit	group=assessment
evaluate	group=assessment
go over	group=assessment
review	group=assessment
scrutinize	group=assessment
analyse	group=assessment
assay	group=assessment
proofread	group=assessment
study	group=assessment
abase	group=remedy
africanize	group=remedy
alcoholize	group=remedy
alleviate	group=remedy
anesthetize	group=remedy
animate	group=remedy
backfill	group=remedy
bastardize	group=remedy
bedew	group=remedy
blast	group=remedy
blemish	group=remedy
bloody	group=remedy
botch	group=remedy
bowdlerize	group=remedy
bungle	group=remedy
capacitate	group=remedy
carbonify	group=remedy
castrate	group=remedy
categorize	group=remedy
catholicize	group=remedy
cauterize	group=remedy
chamfer	group=remedy
chlorinate	group=remedy
christianize	group=remedy
circumcise	group=remedy
circumscribe	group=remedy
coif	group=remedy
commercialize	group=remedy
configure	group=remedy
conflate	group=remedy
constipate	group=remedy
constringe	group=remedy
construct	group=remedy
contextualize	group=remedy
correct	group=remedy
counteract	group=remedy
cremate	group=remedy
deafen	group=remedy
debase	group=remedy
deconstruct	group=remedy
dehumidify	group=remedy
delineate	group=remedy
demean	group=remedy
dement	group=remedy
demobilize	group=remedy
desalinate	group=remedy
desensitize	group=remedy
diffract	group=remedy
disable	group=remedy
dishevel	group=remedy
disinfect	group=remedy
disinter	group=remedy
dispel	group=remedy
dislocate	group=remedy
disorganize	group=remedy
domesticate	group=remedy
edify	group=remedy
emasculate	group=remedy
embitter	group=remedy
embrocate	group=remedy
enhance	group=remedy
enunciate	group=remedy
eternalize	group=remedy
eternize	group=remedy
europeanize	group=remedy
exacerbate	group=remedy
exhume	group=remedy
expropriate	group=remedy
extinguish	group=remedy
fanaticize	group=remedy
federalize	group=remedy
fertilize	group=remedy
flouridate	group=remedy
grade	group=remedy
halve	group=remedy
homogenize	group=remedy
humanize	group=remedy
humidify	group=remedy
hydrogenate	group=remedy
ice	group=remedy
immortalize	group=remedy
inactivate	group=remedy
incinerate	group=remedy
inseminate	group=remedy
inspissate	group=remedy
invert	group=remedy
iodize	group=remedy
light	group=remedy
lighten	group=remedy
magnetize	group=remedy
magnify	group=remedy
marginalize	group=remedy
mechanize	group=remedy
medicate	group=remedy
militarize	group=remedy
mineralize	group=remedy
miniaturize	group=remedy
minimize	group=remedy
mishandle	group=remedy
mismanage	group=remedy
motorize	group=remedy
muddy	group=remedy
mummify	group=remedy
mute	group=remedy
nasalize	group=remedy
nitrify	group=remedy
objectify	group=remedy
obscure	group=remedy
obviate	group=remedy
overshadow	group=remedy
oxygenate	group=remedy
paralyze	group=remedy
pasteurize	group=remedy
perfect	group=remedy
perpetuate	group=remedy
pink	group=remedy
pollard	group=remedy
popularize	group=remedy
prettify	group=remedy
publicize	group=remedy
reanimate	group=remedy
rectify	group=remedy
redact	group=remedy
refract	group=remedy
regularize	group=remedy
remaster	group=remedy
remedy	group=remedy
repair	group=remedy
revise	group=remedy
secularize	group=remedy
sensationalize	group=remedy
shortchange	group=remedy
silence	group=remedy
singe	group=remedy
sinter	group=remedy
sovietize	group=remedy
sterilize	group=remedy
streamline	group=remedy
subvert	group=remedy
tabulate	group=remedy
taiwanize	group=remedy
tart up	group=remedy
tousle	group=remedy
transplant	group=remedy
traumatize	group=remedy
truncate	group=remedy
trivialize	group=remedy
underfeed	group=remedy
upload	group=remedy
urbanize	group=remedy
ventilate	group=remedy
vulgarize	group=remedy
beg	group=beg
ask	group=beg
request	group=beg
supplicate	group=beg
importune	group=beg
bob	group=curtsey
bow	group=curtsey
curtsey	group=curtsey
genuflect	group=curtsey
kneel	group=curtsey
salaam	group=curtsey
salute	group=curtsey
dribble	group=pour
drip	group=pour
pour	group=pour
slop	group=pour
slosh	group=pour
spew	group=pour
spill	group=pour
trickle	group=pour
dip	group=funnel
dunk	group=funnel
ladle	group=funnel
hoe	group=funnel
scoop	group=funnel
siphon	group=funnel
sop	group=funnel
channelize	group=funnel
channel	group=funnel
fit	group=funnel
rake	group=funnel
scrape	group=funnel
shovel	group=funnel
spoon	group=funnel
squash	group=funnel
squish	group=funnel
tuck	group=funnel
wipe	group=funnel
wring	group=funnel
bang	group=funnel
dump	group=funnel
funnel	group=funnel
hammer	group=funnel
pound	group=funnel
push	group=funnel
ram	group=funnel
shake	group=funnel
squeeze	group=funnel
sweep	group=funnel
wedge	group=funnel
archive	group=pocket
bag	group=pocket
bank	group=pocket
barrack	group=pocket
beach	group=pocket
bed	group=pocket
bench	group=pocket
billet	group=pocket
bin	group=pocket
bottle	group=pocket
box	group=pocket
cage	group=pocket
can	group=pocket
case	group=pocket
cellar	group=pocket
cloister	group=pocket
coop	group=pocket
corral	group=pocket
crate	group=pocket
cup	group=pocket
file	group=pocket
fork	group=pocket
garage	group=pocket
hangar	group=pocket
house	group=pocket
imprison	group=pocket
jail	group=pocket
jar	group=pocket
jug	group=pocket
kennel	group=pocket
pasture	group=pocket
pen	group=pocket
pillory	group=pocket
pocket	group=pocket
pot	group=pocket
sheathe	group=pocket
shelve	group=pocket
shoulder	group=pocket
skewer	group=pocket
snare	group=pocket
spindle	group=pocket
spit	group=pocket
spool	group=pocket
string	group=pocket
tassel	group=pocket
tin	group=pocket
trap	group=pocket
tree	group=pocket
warehouse	group=pocket
wharf	group=pocket
berth	group=pocket
dock	group=pocket
drydock	group=pocket
land	group=pocket
moor	group=pocket
ground	group=pocket
lodge	group=pocket
stable	group=pocket
barf	group=breathe
bleed	group=breathe
dribble	group=breathe
drool	group=breathe
pee	group=breathe
piss	group=breathe
puke	group=breathe
shit	group=breathe
spit	group=breathe
sweat	group=breathe
throw up	group=breathe
vomit	group=breathe
weep	group=breathe
breathe	group=breathe
cough	group=breathe
cry	group=breathe
defecate	group=breathe
expectorate	group=breathe
retch	group=breathe
slobber	group=breathe
urinate	group=breathe
hawk	group=breathe
admit	group=admit
allow	group=admit
exclude	group=admit
include	group=admit
permit	group=admit
welcome	group=admit
drop	group=put_direction
elevate	group=put_direction
heel	group=put_direction
hoist	group=put_direction
lift	group=put_direction
lower	group=put_direction
raise	group=put_direction
back	group=put_direction
advert	group=convert
come around	group=convert
fall	group=convert
get	group=convert
get around	group=convert
get down	group=convert
go back	group=convert
resort	group=convert
return	group=convert
revert	group=convert
settle down	group=convert
shift	group=convert
take	group=convert
turn	group=convert
change over	group=convert
convert	group=convert
move over	group=convert
switch	group=convert
switch over	group=convert
base	group=base
establish	group=base
ground	group=base
found	group=base
build	group=base
construe	group=base
barrack	group=lodge
bivouac	group=lodge
board	group=lodge
bunk	group=lodge
camp	group=lodge
dwell	group=lodge
guest	group=lodge
live	group=lodge
lodge	group=lodge
overnight	group=lodge
quarter	group=lodge
reside	group=lodge
room	group=lodge
settle	group=lodge
shack up	group=lodge
shelter	group=lodge
sleep over	group=lodge
squat	group=lodge
stay over	group=lodge
stop	group=lodge
stay	group=lodge
defend	group=defend
insure	group=defend
protect	group=defend
shade	group=defend
preserve	group=defend
guard	group=defend
safeguard	group=defend
clean	group=clear
hollow	group=clear
clear	group=clear
drain	group=clear
empty	group=clear
attend	group=peer
check	group=peer
eavesdrop	group=peer
gape	group=peer
gawk	group=peer
gaze	group=peer
glance	group=peer
glare	group=peer
goggle	group=peer
leer	group=peer
listen	group=peer
look	group=peer
ogle	group=peer
peek	group=peer
peep	group=peer
peer	group=peer
sniff	group=peer
snoop	group=peer
squint	group=peer
stare	group=peer
allow	group=conjecture
believe	group=conjecture
conjecture	group=conjecture
deny	group=conjecture
determine	group=conjecture
doubt	group=conjecture
expect	group=conjecture
feel	group=conjecture
foreknow	group=conjecture
foresee	group=conjecture
foretell	group=conjecture
guess	group=conjecture
hold	group=conjecture
infer	group=conjecture
know	group=conjecture
presume	group=conjecture
prophesy	group=conjecture
realize	group=conjecture
repute	group=conjecture
recognize	group=conjecture
speculate	group=conjecture
surmise	group=conjecture
suspect	group=conjecture
swear	group=conjecture
trust	group=conjecture
mean	group=conjecture
vaticinate	group=conjecture
anticipate	group=conjecture
prognosticate	group=conjecture
admit	group=conjecture
affirm	group=conjecture
assert	group=conjecture
attest	group=conjecture
aver	group=conjecture
avow	group=conjecture
avouch	group=conjecture
claim	group=conjecture
confirm	group=conjecture
contend	group=conjecture
discover	group=conjecture
grant	group=conjecture
guarantee	group=conjecture
maintain	group=conjecture
observe	group=conjecture
reaffirm	group=conjecture
reassert	group=conjecture
show	group=conjecture
addict	group=addict
bias	group=addict
dispose	group=addict
incline	group=addict
predispose	group=addict
woo	group=addict
slant	group=addict
ban	group=forbid
bar	group=forbid
block	group=forbid
deter	group=forbid
discourage	group=forbid
dissuade	group=forbid
forbid	group=forbid
hamper	group=forbid
hinder	group=forbid
impede	group=forbid
inhibit	group=forbid
obstruct	group=forbid
preclude	group=forbid
prevent	group=forbid
prohibit	group=forbid
restrain	group=forbid
stop	group=forbid
confine	group=limit
limit	group=limit
reduce	group=limit
restrict	group=limit
restrain	group=limit
constrain	group=limit
balk	group=flinch
cower	group=flinch
cringe	group=flinch
flinch	group=flinch
quail	group=flinch
recoil	group=flinch
shrink	group=flinch
wince	group=flinch
hit	group=bump
run	group=bump
bang	group=bump
bash	group=bump
brush	group=bump
bump	group=bump
butt	group=bump
clang	group=bump
clash	group=bump
clatter	group=bump
collide	group=bump
crack	group=bump
crash	group=bump
crunch	group=bump
hammer	group=bump
knock	group=bump
ram	group=bump
rap	group=bump
slam	group=bump
slap	group=bump
smack	group=bump
smash	group=bump
squash	group=bump
strike	group=bump
thud	group=bump
thump	group=bump
buff	group=wipe_manner
distill	group=wipe_manner
distil	group=wipe_manner
exorcise	group=wipe_manner
expunge	group=wipe_manner
expurgate	group=wipe_manner
flush	group=wipe_manner
leach	group=wipe_manner
offload	group=wipe_manner
polish	group=wipe_manner
purge	group=wipe_manner
shave	group=wipe_manner
smooth	group=wipe_manner
skim	group=wipe_manner
soak	group=wipe_manner
strain	group=wipe_manner
trim	group=wipe_manner
unload	group=wipe_manner
weed	group=wipe_manner
whisk	group=wipe_manner
winnow	group=wipe_manner
wring	group=wipe_manner
bail	group=wipe_manner
dab	group=wipe_manner
dust	group=wipe_manner
erase	group=wipe_manner
lick	group=wipe_manner
pluck	group=wipe_manner
prune	group=wipe_manner
rinse	group=wipe_manner
rub	group=wipe_manner
scour	group=wipe_manner
scrape	group=wipe_manner
scratch	group=wipe_manner
scrub	group=wipe_manner
squeeze	group=wipe_manner
strip	group=wipe_manner
suck	group=wipe_manner
suction	group=wipe_manner
swab	group=wipe_manner
sweep	group=wipe_manner
wash	group=wipe_manner
wear	group=wipe_manner
wipe	group=wipe_manner
buck	group=body_internal_motion
fidget	group=body_internal_motion
flap	group=body_internal_motion
gyrate	group=body_internal_motion
jiggle	group=body_internal_motion
kick	group=body_internal_motion
rock	group=body_internal_motion
squirm	group=body_internal_motion
sway	group=body_internal_motion
teeter	group=body_internal_motion
totter	group=body_internal_motion
twitch	group=body_internal_motion
waggle	group=body_internal_motion
wiggle	group=body_internal_motion
wobble	group=body_internal_motion
wriggle	group=body_internal_motion
succeed	group=succeed
excel	group=succeed
manage	group=succeed
fail	group=succeed
flub	group=succeed
calve	group=calve
cub	group=calve
fawn	group=calve
foal	group=calve
kitten	group=calve
lamb	group=calve
litter	group=calve
pup	group=calve
spawn	group=calve
whelp	group=calve
file	group=wipe_instr
filter	group=wipe_instr
hoover	group=wipe_instr
iron	group=wipe_instr
plough	group=wipe_instr
sandpaper	group=wipe_instr
sponge	group=wipe_instr
squeegee	group=wipe_instr
towel	group=wipe_instr
brush	group=wipe_instr
comb	group=wipe_instr
hose	group=wipe_instr
mop	group=wipe_instr
plow	group=wipe_instr
rake	group=wipe_instr
shear	group=wipe_instr
shovel	group=wipe_instr
siphon	group=wipe_instr
vacuum	group=wipe_instr
allow	group=allow
approve	group=allow
permit	group=allow
sanction	group=allow
tolerate	group=allow
heave	group=push
jerk	group=push
pull	group=push
tug	group=push
yank	group=push
jostle	group=push
nudge	group=push
press	group=push
push	group=push
shove	group=push
squeeze	group=push
thrust	group=push
face	group=confront
confront	group=confront
head on	group=confront
undertake	group=confront
tackle	group=confront
take on	group=confront
set about	group=confront
go about	group=confront
approach	group=confront
brave	group=confront
handle	group=confront
intercept	group=confront
target	group=confront
rival	group=confront
counter	group=confront
pre-empt	group=confront
combat	group=confront
breast	group=confront
develop	group=grow
evolve	group=grow
generate	group=grow
grow	group=grow
hatch	group=grow
maturate	group=grow
mature	group=grow
redevelop	group=grow
appear	group=appear
arise	group=appear
awake	group=appear
awaken	group=appear
break	group=appear
burst	group=appear
coalesce	group=appear
come	group=appear
dawn	group=appear
derive	group=appear
develop	group=appear
emanate	group=appear
emerge	group=appear
erupt	group=appear
evolve	group=appear
exude	group=appear
flow	group=appear
form	group=appear
grow	group=appear
gush	group=appear
irrupt	group=appear
issue	group=appear
materialize	group=appear
open	group=appear
plop	group=appear
pop up	group=appear
reappear	group=appear
re-emerge	group=appear
result	group=appear
rise	group=appear
show up	group=appear
spill	group=appear
spread	group=appear
spring up	group=appear
steal	group=appear
stem	group=appear
stream	group=appear
supervene	group=appear
surge	group=appear
take shape	group=appear
wax	group=appear
deal	group=give
lend	group=give
loan	group=give
pass	group=give
peddle	group=give
refund	group=give
render	group=give
give	group=give
hock	group=give
hawk	group=give
rent	group=give
sell	group=give
lease	group=give
pawn	group=give
hire	group=hire
recruit	group=hire
employ	group=hire
contract	group=hire
engage	group=hire
take	group=hire
sign	group=hire
sign on	group=hire
sign up	group=hire
subcontract	group=hire
train	group=hire
enlist	group=hire
reinstate	group=hire
move	group=slide
scoot	group=slide
bounce	group=slide
dart	group=slide
float	group=slide
roll	group=slide
slide	group=slide
come	group=become
turn	group=become
get	group=become
go	group=become
grow	group=become
fall	group=become
December	group=weekend
holiday	group=weekend
honeymoon	group=weekend
junket	group=weekend
overnight	group=weekend
sojourn	group=weekend
summer	group=weekend
vacation	group=weekend
weekend	group=weekend
winter	group=weekend
lay	group=put_spatial
prop	group=put_spatial
underlay	group=put_spatial
dangle	group=put_spatial
hang	group=put_spatial
lean	group=put_spatial
perch	group=put_spatial
rest	group=put_spatial
sit	group=put_spatial
stand	group=put_spatial
suspend	group=put_spatial
bounce	group=roll
drift	group=roll
drop	group=roll
float	group=roll
glide	group=roll
move	group=roll
nose	group=roll
roll	group=roll
slide	group=roll
swing	group=roll
coil	group=roll
revolve	group=roll
rotate	group=roll
spin	group=roll
turn	group=roll
twirl	group=roll
twist	group=roll
whirl	group=roll
wind	group=roll
snake	group=roll
soar	group=roll
spiral	group=roll
undulate	group=roll
convulse	group=body_internal_states
cower	group=body_internal_states
quake	group=body_internal_states
quiver	group=body_internal_states
shake	group=body_internal_states
shiver	group=body_internal_states
shudder	group=body_internal_states
tremble	group=body_internal_states
writhe	group=body_internal_states
hoard	group=keep
keep	group=keep
leave	group=keep
store	group=keep
stock	group=keep
stockpile	group=keep
expect	group=wish
wish	group=wish
hope	group=wish
intend	group=wish
mean	group=wish
plan	group=wish
propose	group=wish
think	group=wish
aim	group=wish
dream	group=wish
imagine	group=wish
yen	group=wish
bob	group=modes_of_being_with_motion
bow	group=modes_of_being_with_motion
circulate	group=modes_of_being_with_motion
creep	group=modes_of_being_with_motion
dance	group=modes_of_being_with_motion
drift	group=modes_of_being_with_motion
eddy	group=modes_of_being_with_motion
falter	group=modes_of_being_with_motion
flap	group=modes_of_being_with_motion
float	group=modes_of_being_with_motion
flutter	group=modes_of_being_with_motion
hover	group=modes_of_being_with_motion
jiggle	group=modes_of_being_with_motion
joggle	group=modes_of_being_with_motion
oscillate	group=modes_of_being_with_motion
pulsate	group=modes_of_being_with_motion
pulse	group=modes_of_being_with_motion
quake	group=modes_of_being_with_motion
quiver	group=modes_of_being_with_motion
recirculate	group=modes_of_being_with_motion
revolve	group=modes_of_being_with_motion
rock	group=modes_of_being_with_motion
rotate	group=modes_of_being_with_motion
shake	group=modes_of_being_with_motion
stir	group=modes_of_being_with_motion
swag	group=modes_of_being_with_motion
sway	group=modes_of_being_with_motion
swirl	group=modes_of_being_with_motion
teeter	group=modes_of_being_with_motion
throb	group=modes_of_being_with_motion
totter	group=modes_of_being_with_motion
tremble	group=modes_of_being_with_motion
undulate	group=modes_of_being_with_motion
vacillate	group=modes_of_being_with_motion
vibrate	group=modes_of_being_with_motion
waft	group=modes_of_being_with_motion
wave	group=modes_of_being_with_motion
waver	group=modes_of_being_with_motion
wiggle	group=modes_of_being_with_motion
wobble	group=modes_of_being_with_motion
worm	group=modes_of_being_with_motion
writhe	group=modes_of_being_with_motion
roil	group=modes_of_being_with_motion
alleviate	group=free
liberate	group=free
discharge	group=free
exonerate	group=free
absolve	group=free
acquit	group=free
clear	group=free
free	group=free
cure	group=free
relieve	group=free
emancipate	group=free
release	group=free
rerelease	group=free
betroth	group=contribute
forgo	group=contribute
lose	group=contribute
refer	group=contribute
relinquish	group=contribute
remit	group=contribute
resign	group=contribute
restore	group=contribute
gift	group=contribute
hand out	group=contribute
pass out	group=contribute
shell out	group=contribute
abnegate	group=contribute
disseminate	group=contribute
distribute	group=contribute
administer	group=contribute
circularize	group=contribute
contribute	group=contribute
donate	group=contribute
forfeit	group=contribute
resubmit	group=contribute
sacrifice	group=contribute
submit	group=contribute
surrender	group=contribute
disburse	group=contribute
extend	group=contribute
proffer	group=contribute
return	group=contribute
transfer	group=contribute
reimburse	group=contribute
break	group=break
break apart	group=break
break down	group=break
break up	group=break
chip	group=break
cleave	group=break
crack	group=break
crash	group=break
crush	group=break
dissolve	group=break
fissure	group=break
fracture	group=break
fragment	group=break
rend	group=break
rive	group=break
rip	group=break
shatter	group=break
shred	group=break
sliver	group=break
smash	group=break
snap	group=break
splinter	group=break
split	group=break
tear	group=break
belch	group=hiccup
blink	group=hiccup
blush	group=hiccup
burp	group=hiccup
eruct	group=hiccup
fart	group=hiccup
flush	group=hiccup
hiccup	group=hiccup
pant	group=hiccup
salivate	group=hiccup
shiver	group=hiccup
sneeze	group=hiccup
sniffle	group=hiccup
snore	group=hiccup
snuff	group=hiccup
snuffle	group=hiccup
swallow	group=hiccup
wheeze	group=hiccup
yawn	group=hiccup
demonstrate	group=transfer_mesg
elucidate	group=transfer_mesg
explain	group=transfer_mesg
explicate	group=transfer_mesg
expound	group=transfer_mesg
justify	group=transfer_mesg
narrate	group=transfer_mesg
pose	group=transfer_mesg
preach	group=transfer_mesg
recap	group=transfer_mesg
recite	group=transfer_mesg
relay	group=transfer_mesg
sniff	group=transfer_mesg
illustrate	group=transfer_mesg
verify	group=transfer_mesg
corroborate	group=transfer_mesg
communicate	group=transfer_mesg
outline	group=transfer_mesg
summarize	group=transfer_mesg
sum up	group=transfer_mesg
boil down	group=transfer_mesg
snitch	group=transfer_mesg
dictate	group=transfer_mesg
quote	group=transfer_mesg
read	group=transfer_mesg
show	group=transfer_mesg
teach	group=transfer_mesg
tell	group=transfer_mesg
write	group=transfer_mesg
overspread	group=exist
coexist	group=exist
dwell	group=exist
exist	group=exist
extend	group=exist
flourish	group=exist
languish	group=exist
linger	group=exist
live	group=exist
loom	group=exist
lurk	group=exist
persist	group=exist
predominate	group=exist
prevail	group=exist
prosper	group=exist
remain	group=exist
reside	group=exist
shelter	group=exist
stay	group=exist
thrive	group=exist
tower	group=exist
vegetate	group=exist
wait	group=exist
persevere	group=exist
endure	group=exist
survive	group=exist
announce	group=reflexive_appearance
assert	group=reflexive_appearance
declare	group=reflexive_appearance
define	group=reflexive_appearance
display	group=reflexive_appearance
exhibit	group=reflexive_appearance
expose	group=reflexive_appearance
express	group=reflexive_appearance
flaunt	group=reflexive_appearance
form	group=reflexive_appearance
intrude	group=reflexive_appearance
manifest	group=reflexive_appearance
offer	group=reflexive_appearance
pose	group=reflexive_appearance
present	group=reflexive_appearance
proffer	group=reflexive_appearance
propose	group=reflexive_appearance
reassert	group=reflexive_appearance
recommend	group=reflexive_appearance
reveal	group=reflexive_appearance
shape	group=reflexive_appearance
show	group=reflexive_appearance
suggest	group=reflexive_appearance
babble	group=sound_emission
bang	group=sound_emission
beat	group=sound_emission
beep	group=sound_emission
bellow	group=sound_emission
blare	group=sound_emission
blast	group=sound_emission
blat	group=sound_emission
boom	group=sound_emission
bubble	group=sound_emission
burble	group=sound_emission
burr	group=sound_emission
buzz	group=sound_emission
caterwaul	group=sound_emission
chatter	group=sound_emission
chime	group=sound_emission
chink	group=sound_emission
chir	group=sound_emission
chitter	group=sound_emission
chug	group=sound_emission
clack	group=sound_emission
clang	group=sound_emission
clank	group=sound_emission
clap	group=sound_emission
clash	group=sound_emission
clatter	group=sound_emission
click	group=sound_emission
cling	group=sound_emission
clink	group=sound_emission
clomp	group=sound_emission
clump	group=sound_emission
clunk	group=sound_emission
crack	group=sound_emission
crackle	group=sound_emission
crash	group=sound_emission
creak	group=sound_emission
crepitate	group=sound_emission
crunch	group=sound_emission
cry	group=sound_emission
ding	group=sound_emission
dong	group=sound_emission
drone	group=sound_emission
explode	group=sound_emission
fizz	group=sound_emission
fizzle	group=sound_emission
groan	group=sound_emission
growl	group=sound_emission
gurgle	group=sound_emission
hiss	group=sound_emission
hoot	group=sound_emission
honk	group=sound_emission
howl	group=sound_emission
hum	group=sound_emission
jangle	group=sound_emission
jingle	group=sound_emission
keen	group=sound_emission
knell	group=sound_emission
knock	group=sound_emission
lilt	group=sound_emission
mewl	group=sound_emission
moan	group=sound_emission
murmur	group=sound_emission
patter	group=sound_emission
peal	group=sound_emission
ping	group=sound_emission
pink	group=sound_emission
pipe	group=sound_emission
plash	group=sound_emission
plink	group=sound_emission
plonk	group=sound_emission
plop	group=sound_emission
plunk	group=sound_emission
pop	group=sound_emission
purr	group=sound_emission
putter	group=sound_emission
rap	group=sound_emission
rasp	group=sound_emission
rattle	group=sound_emission
ring	group=sound_emission
roar	group=sound_emission
roll	group=sound_emission
rumble	group=sound_emission
rustle	group=sound_emission
scream	group=sound_emission
screech	group=sound_emission
shriek	group=sound_emission
shrill	group=sound_emission
sing	group=sound_emission
sizzle	group=sound_emission
snap	group=sound_emission
sound	group=sound_emission
sough	group=sound_emission
sploosh	group=sound_emission
splash	group=sound_emission
splutter	group=sound_emission
sputter	group=sound_emission
squawk	group=sound_emission
squeak	group=sound_emission
squeal	group=sound_emission
squelch	group=sound_emission
strike	group=sound_emission
swish	group=sound_emission
swoosh	group=sound_emission
thrum	group=sound_emission
thud	group=sound_emission
thump	group=sound_emission
thunder	group=sound_emission
thunk	group=sound_emission
tick	group=sound_emission
ting	group=sound_emission
tinkle	group=sound_emission
toll	group=sound_emission
toot	group=sound_emission
tootle	group=sound_emission
trill	group=sound_emission
trumpet	group=sound_emission
twang	group=sound_emission
ululate	group=sound_emission
vroom	group=sound_emission
wail	group=sound_emission
wheeze	group=sound_emission
whine	group=sound_emission
whir	group=sound_emission
whish	group=sound_emission
whisper	group=sound_emission
whistle	group=sound_emission
whoosh	group=sound_emission
whump	group=sound_emission
zing	group=sound_emission
broadcast	group=instr_communication
cable	group=instr_communication
e-mail	group=instr_communication
fax	group=instr_communication
modem	group=instr_communication
netmail	group=instr_communication
phone	group=instr_communication
radio	group=instr_communication
relay	group=instr_communication
satellite	group=instr_communication
semaphore	group=instr_communication
sign	group=instr_communication
signal	group=instr_communication
telecast	group=instr_communication
telegraph	group=instr_communication
telephone	group=instr_communication
telex	group=instr_communication
wire	group=instr_communication
wireless	group=instr_communication
don	group=simple_dressing
doff	group=simple_dressing
wear	group=simple_dressing
amble	group=run
ambulate	group=run
backpack	group=run
bolt	group=run
bound	group=run
bustle	group=run
caper	group=run
carom	group=run
cavort	group=run
charge	group=run
clamber	group=run
climb	group=run
clump	group=run
crawl	group=run
creep	group=run
dodder	group=run
flit	group=run
flounce	group=run
frolic	group=run
gallivant	group=run
gambol	group=run
ghost	group=run
globetrot	group=run
goose step	group=run
hike	group=run
hitchhike	group=run
hopscotch	group=run
limp	group=run
lollop	group=run
lumber	group=run
lurch	group=run
meander	group=run
mince	group=run
mosey	group=run
nip	group=run
pace	group=run
pounce	group=run
repair	group=run
romp	group=run
sashay	group=run
saunter	group=run
scamper	group=run
scram	group=run
scramble	group=run
scud	group=run
scurry	group=run
scutter	group=run
scuttle	group=run
shamble	group=run
shuffle	group=run
sidle	group=run
skedaddle	group=run
skulk	group=run
sleepwalk	group=run
slink	group=run
slither	group=run
slog	group=run
slouch	group=run
somersault	group=run
sprint	group=run
spring	group=run
stagger	group=run
step	group=run
stomp	group=run
stray	group=run
streak	group=run
stumble	group=run
stump	group=run
swag	group=run
swagger	group=run
swerve	group=run
tear	group=run
tiptoe	group=run
toddle	group=run
toil	group=run
totter	group=run
tread	group=run
troop	group=run
trundle	group=run
waddle	group=run
weave	group=run
whiz	group=run
worm	group=run
yaw	group=run
zigzag	group=run
zoom	group=run
involve	group=involve
engage	group=involve
relate	group=involve
include	group=involve
enroll	group=involve
accept	group=accept
understand	group=accept
encourage	group=accept
discourage	group=accept
disprefer	group=accept
reject	group=accept
repent	group=accept
rue	group=accept
ache	group=tingle
burn	group=tingle
hum	group=tingle
palpitate	group=tingle
pound	group=tingle
prickle	group=tingle
pucker	group=tingle
reel	group=tingle
smart	group=tingle
spin	group=tingle
split	group=tingle
sting	group=tingle
swim	group=tingle
throb	group=tingle
tickle	group=tingle
tingle	group=tingle
twinge	group=tingle
hit	group=hurt
jam	group=hurt
graze	group=hurt
chafe	group=hurt
stub	group=hurt
break	group=hurt
chip	group=hurt
fracture	group=hurt
pull	group=hurt
rupture	group=hurt
split	group=hurt
splinter	group=hurt
sprain	group=hurt
tear	group=hurt
turn	group=hurt
twist	group=hurt
bark	group=hurt
bite	group=hurt
bruise	group=hurt
bump	group=hurt
burn	group=hurt
contuse	group=hurt
cut	group=hurt
hurt	group=hurt
injure	group=hurt
nick	group=hurt
prick	group=hurt
scald	group=hurt
scratch	group=hurt
skin	group=hurt
strain	group=hurt
sunburn	group=hurt
wrench	group=hurt
chase	group=chase
follow	group=chase
pursue	group=chase
shadow	group=chase
tail	group=chase
track	group=chase
trail	group=chase
beam	group=nonverbal_expression
blubber	group=nonverbal_expression
cackle	group=nonverbal_expression
chortle	group=nonverbal_expression
chuckle	group=nonverbal_expression
cough	group=nonverbal_expression
cry	group=nonverbal_expression
frown	group=nonverbal_expression
gape	group=nonverbal_expression
gasp	group=nonverbal_expression
gawk	group=nonverbal_expression
giggle	group=nonverbal_expression
glare	group=nonverbal_expression
glower	group=nonverbal_expression
goggle	group=nonverbal_expression
grimace	group=nonverbal_expression
grin	group=nonverbal_expression
groan	group=nonverbal_expression
growl	group=nonverbal_expression
guffaw	group=nonverbal_expression
howl	group=nonverbal_expression
jeer	group=nonverbal_expression
laugh	group=nonverbal_expression
lour	group=nonverbal_expression
moan	group=nonverbal_expression
pout	group=nonverbal_expression
scoff	group=nonverbal_expression
scowl	group=nonverbal_expression
sigh	group=nonverbal_expression
simper	group=nonverbal_expression
smile	group=nonverbal_expression
smirk	group=nonverbal_expression
sneer	group=nonverbal_expression
sneeze	group=nonverbal_expression
snicker	group=nonverbal_expression
sniff	group=nonverbal_expression
snigger	group=nonverbal_expression
snivel	group=nonverbal_expression
snore	group=nonverbal_expression
snort	group=nonverbal_expression
sob	group=nonverbal_expression
titter	group=nonverbal_expression
weep	group=nonverbal_expression
whistle	group=nonverbal_expression
yawn	group=nonverbal_expression
hem	group=nonverbal_expression
bayonet	group=spank
belt	group=spank
biff	group=spank
birch	group=spank
bludgeon	group=spank
bonk	group=spank
brain	group=spank
bump	group=spank
cane	group=spank
clobber	group=spank
clout	group=spank
club	group=spank
conk	group=spank
cosh	group=spank
crack	group=spank
crunch	group=spank
cudgel	group=spank
cuff	group=spank
elbow	group=spank
flagellate	group=spank
flog	group=spank
gash	group=spank
knee	group=spank
knife	group=spank
k.o.	group=spank
paddle	group=spank
paddywhack	group=spank
pummel	group=spank
slam	group=spank
sock	group=spank
spank	group=spank
stabb	group=spank
strap	group=spank
thrash	group=spank
thump	group=spank
truncheon	group=spank
wallop	group=spank
whip	group=spank
whisk	group=spank
horsewhip	group=spank
fire	group=fire
dismiss	group=fire
sack	group=fire
drop	group=fire
unseat	group=fire
oust	group=fire
expel	group=fire
remove	group=fire
can	group=fire
send away	group=fire
suspend	group=fire
force out	group=fire
terminate	group=fire
give the_boot	group=fire
lay off	group=fire
let go	group=fire
shitcan	group=fire
consult	group=battle
contend	group=battle
exile	group=battle
argue	group=battle
bargain	group=battle
battle	group=battle
bicker	group=battle
brawl	group=battle
clash	group=battle
combat	group=battle
compete	group=battle
conflict	group=battle
correspond	group=battle
communicate	group=battle
dicker	group=battle
differ	group=battle
disagree	group=battle
dispute	group=battle
duel	group=battle
feud	group=battle
fight	group=battle
joust	group=battle
quarrel	group=battle
quibble	group=battle
refight	group=battle
scuffle	group=battle
skirmish	group=battle
spar	group=battle
spat	group=battle
struggle	group=battle
squabble	group=battle
tilt	group=battle
tussle	group=battle
vie	group=battle
war	group=battle
wrangle	group=battle
wrestle	group=battle
angle	group=meander
ascend	group=meander
bend	group=meander
cascade	group=meander
climb	group=meander
crawl	group=meander
crest	group=meander
crisscross	group=meander
cross	group=meander
cut	group=meander
descend	group=meander
dip	group=meander
dive	group=meander
drop	group=meander
edge	group=meander
emerge	group=meander
go	group=meander
meander	group=meander
lance	group=meander
mount	group=meander
pass	group=meander
plummet	group=meander
plunge	group=meander
rise	group=meander
round	group=meander
run	group=meander
skirt	group=meander
slant	group=meander
snake	group=meander
straggle	group=meander
stretch	group=meander
sweep	group=meander
tumble	group=meander
turn	group=meander
twist	group=meander
undulate	group=meander
wander	group=meander
weave	group=meander
wind	group=meander
range	group=meander
swerve	group=meander
veer	group=meander
zag	group=meander
zig	group=meander
zigzag	group=meander
converge	group=meander
bark	group=pit
beard	group=pit
bone	group=pit
burl	group=pit
core	group=pit
gill	group=pit
gut	group=pit
head	group=pit
hull	group=pit
husk	group=pit
lint	group=pit
louse	group=pit
milk	group=pit
peel	group=pit
pinion	group=pit
pip	group=pit
pit	group=pit
pith	group=pit
pod	group=pit
poll	group=pit
pulp	group=pit
rind	group=pit
scale	group=pit
scalp	group=pit
seed	group=pit
shell	group=pit
shuck	group=pit
skin	group=pit
snail	group=pit
stalk	group=pit
stem	group=pit
stone	group=pit
string	group=pit
tail	group=pit
tassel	group=pit
vein	group=pit
weed	group=pit
wind	group=pit
worm	group=pit
zest	group=pit
annotate	group=image_impression
applique	group=image_impression
emboss	group=image_impression
embroider	group=image_impression
engrave	group=image_impression
etch	group=image_impression
handpaint	group=image_impression
imprint	group=image_impression
incise	group=image_impression
ingrain	group=image_impression
inscribe	group=image_impression
mark	group=image_impression
paint	group=image_impression
reinscribe	group=image_impression
scar	group=image_impression
set	group=image_impression
sign	group=image_impression
stamp	group=image_impression
stipple	group=image_impression
tattoo	group=image_impression
tool	group=image_impression
baa	group=animal_sounds
bark	group=animal_sounds
bay	group=animal_sounds
bellow	group=animal_sounds
blat	group=animal_sounds
bleat	group=animal_sounds
bray	group=animal_sounds
buzz	group=animal_sounds
cackle	group=animal_sounds
call	group=animal_sounds
caw	group=animal_sounds
chatter	group=animal_sounds
cheep	group=animal_sounds
chirp	group=animal_sounds
chirrup	group=animal_sounds
chitter	group=animal_sounds
cluck	group=animal_sounds
coo	group=animal_sounds
croak	group=animal_sounds
crow	group=animal_sounds
cuckoo	group=animal_sounds
drone	group=animal_sounds
gobble	group=animal_sounds
growl	group=animal_sounds
grunt	group=animal_sounds
hee-haw	group=animal_sounds
hiss	group=animal_sounds
honk	group=animal_sounds
hoot	group=animal_sounds
howl	group=animal_sounds
ki-yi	group=animal_sounds
low	group=animal_sounds
meow	group=animal_sounds
mew	group=animal_sounds
moo	group=animal_sounds
neigh	group=animal_sounds
oink	group=animal_sounds
peep	group=animal_sounds
pipe	group=animal_sounds
purr	group=animal_sounds
quack	group=animal_sounds
roar	group=animal_sounds
scrawk	group=animal_sounds
squawk	group=animal_sounds
squeak	group=animal_sounds
squeal	group=animal_sounds
stridulate	group=animal_sounds
trill	group=animal_sounds
tweet	group=animal_sounds
twitter	group=animal_sounds
wail	group=animal_sounds
warble	group=animal_sounds
whimper	group=animal_sounds
whinny	group=animal_sounds
whistle	group=animal_sounds
woof	group=animal_sounds
yap	group=animal_sounds
yell	group=animal_sounds
yelp	group=animal_sounds
yip	group=animal_sounds
yowl	group=animal_sounds
boom	group=animal_sounds
rattle	group=animal_sounds
groan	group=animal_sounds
ululate	group=animal_sounds
moan	group=animal_sounds
rumble	group=animal_sounds
screech	group=animal_sounds
snarl	group=animal_sounds
thunder	group=animal_sounds
trumpet	group=animal_sounds
wheeze	group=animal_sounds
whine	group=animal_sounds
allow	group=order
beseech	group=order
call	group=order
hail	group=order
invite	group=order
okay	group=order
permit	group=order
summon	group=order
ask	group=order
command	group=order
demand	group=order
order	group=order
require	group=order
acquiesce	group=acquiesce
submit	group=acquiesce
give in	group=acquiesce
bow	group=acquiesce
defer	group=acquiesce
accede	group=acquiesce
succumb	group=acquiesce
yield	group=acquiesce
capitulate	group=acquiesce
misconstrue	group=comprehend
misinterpret	group=comprehend
misunderstand	group=comprehend
misapprehend	group=comprehend
understand	group=comprehend
grasp	group=comprehend
comprehend	group=comprehend
apprehend	group=comprehend
follow	group=comprehend
fathom	group=comprehend
hasten	group=rush
hurry	group=rush
rush	group=rush
deal	group=cope
cope	group=cope
manage	group=cope
grapple	group=cope
get by	group=cope
get through	group=cope
accept	group=obtain
accrue	group=obtain
accumulate	group=obtain
appropriate	group=obtain
borrow	group=obtain
cadge	group=obtain
commandeer	group=obtain
collect	group=obtain
exact	group=obtain
grab	group=obtain
inherit	group=obtain
receive	group=obtain
recoup	group=obtain
recover	group=obtain
regain	group=obtain
retrieve	group=obtain
seize	group=obtain
select	group=obtain
snatch	group=obtain
source	group=obtain
subselect	group=obtain
arrogate	group=obtain
acquire	group=obtain
obtain	group=obtain
purchase	group=obtain
ail	group=pain
bother	group=pain
burn	group=pain
hurt	group=pain
itch	group=pain
pain	group=pain
wrench	group=pain
accumulate	group=herd
aggregate	group=herd
amass	group=herd
assemble	group=herd
cluster	group=herd
collect	group=herd
congregate	group=herd
convene	group=herd
flock	group=herd
gather	group=herd
group	group=herd
herd	group=herd
huddle	group=herd
mass	group=herd
reconvene	group=herd
assure	group=promise
guarantee	group=promise
promise	group=promise
ascertain	group=promise
carve	group=scribble
chalk	group=scribble
charcoal	group=scribble
copy	group=scribble
crayon	group=scribble
doodle	group=scribble
draw	group=scribble
forge	group=scribble
ink	group=scribble
misspell	group=scribble
paint	group=scribble
pencil	group=scribble
plot	group=scribble
print	group=scribble
scratch	group=scribble
scrawl	group=scribble
scribble	group=scribble
sketch	group=scribble
spell	group=scribble
spraypaint	group=scribble
stencil	group=scribble
trace	group=scribble
type	group=scribble
write	group=scribble
print out	group=scribble
print up	group=scribble
underscore	group=scribble
underline	group=scribble
bottlefeed	group=feeding
breastfeed	group=feeding
feed	group=feeding
force-feed	group=feeding
handfeed	group=feeding
nurse	group=feeding
spoonfeed	group=feeding
suckle	group=feeding
chew	group=chew
chomp	group=chew
crunch	group=chew
gnaw	group=chew
gum	group=chew
masticate	group=chew
munch	group=chew
nibble	group=chew
pick	group=chew
peck	group=chew
lick	group=chew
teethe	group=chew
lap	group=chew
sip	group=chew
slurp	group=chew
suck	group=chew
scent	group=stalk
smell	group=stalk
stalk	group=stalk
taste	group=stalk
track	group=stalk
whiff	group=stalk
go on	group=begin
pledge	group=begin
proceed	group=begin
begin	group=begin
start	group=begin
start off	group=begin
commence	group=begin
recommence	group=begin
resume	group=begin
undertake	group=begin
appraise	group=price
approximate	group=price
assess	group=price
auction	group=price
calibrate	group=price
estimate	group=price
fix	group=price
gauge	group=price
meter	group=price
overestimate	group=price
peg	group=price
price	group=price
rate	group=price
reappraise	group=price
value	group=price
admix	group=mix
consolidate	group=mix
intermix	group=mix
scramble	group=mix
tumble	group=mix
cream	group=mix
amalgamate	group=mix
blend	group=mix
coalesce	group=mix
combine	group=mix
compound	group=mix
commingle	group=mix
decoct	group=mix
fuse	group=mix
meld	group=mix
merge	group=mix
mingle	group=mix
mix	group=mix
recombine	group=mix
add	group=mix
tie	group=mix
connect	group=mix
join	group=mix
link	group=mix
pair	group=mix
pool	group=mix
network	group=mix
rejoin	group=mix
unite	group=mix
control	group=enforce
enforce	group=enforce
impose	group=enforce
cheer	group=marvel
cringe	group=marvel
enthuse	group=marvel
exult	group=marvel
fume	group=marvel
gladden	group=marvel
madden	group=marvel
marvel	group=marvel
rage	group=marvel
rejoice	group=marvel
sadden	group=marvel
sicken	group=marvel
start	group=marvel
swoon	group=marvel
thrill	group=marvel
wonder	group=marvel
flip out	group=marvel
freak out	group=marvel
go apeshit	group=marvel
go ballistic	group=marvel
lose it	group=marvel
chafe	group=marvel
bother	group=marvel
care	group=marvel
fret	group=marvel
mind	group=marvel
moon	group=marvel
rage	group=marvel
rejoice	group=marvel
rhapsodize	group=marvel
stew	group=marvel
stress	group=marvel
sulk	group=marvel
worry	group=marvel
flip out	group=marvel
freak out	group=marvel
go apeshit	group=marvel
go ballistic	group=marvel
lose it	group=marvel
bleed	group=marvel
care	group=marvel
cry	group=marvel
fear	group=marvel
feel	group=marvel
grieve	group=marvel
mourn	group=marvel
weep	group=marvel
ache	group=marvel
hurt	group=marvel
suffer	group=marvel
bask	group=marvel
delight	group=marvel
exult	group=marvel
glory	group=marvel
luxuriate	group=marvel
rejoice	group=marvel
revel	group=marvel
wallow	group=marvel
approve	group=marvel
beware	group=marvel
despair	group=marvel
disapprove	group=marvel
sicken	group=marvel
tire	group=marvel
weary	group=marvel
groove	group=marvel
agonize	group=marvel
anger	group=marvel
anguish	group=marvel
delight	group=marvel
enthuse	group=marvel
exult	group=marvel
fret	group=marvel
fume	group=marvel
gloat	group=marvel
grieve	group=marvel
gush	group=marvel
hallucinate	group=marvel
hunger	group=marvel
marvel	group=marvel
meditate	group=marvel
moon	group=marvel
mope	group=marvel
mourn	group=marvel
muse	group=marvel
obsess	group=marvel
puzzle	group=marvel
rage	group=marvel
rave	group=marvel
reflect	group=marvel
rejoice	group=marvel
rhapsodize	group=marvel
ruminate	group=marvel
salivate	group=marvel
seethe	group=marvel
triumph	group=marvel
wonder	group=marvel
worry	group=marvel
sorrow	group=marvel
flip out	group=marvel
freak out	group=marvel
go apeshit	group=marvel
go ballistic	group=marvel
lose it	group=marvel
chafe	group=marvel
react	group=marvel
thrill	group=marvel
advance	group=future_having
allocate	group=future_having
allot	group=future_having
apportion	group=future_having
assign	group=future_having
award	group=future_having
bequeath	group=future_having
cede	group=future_having
concede	group=future_having
devolve	group=future_having
extend	group=future_having
grant	group=future_having
guarantee	group=future_having
issue	group=future_having
leave	group=future_having
offer	group=future_having
owe	group=future_having
portion	group=future_having
promise	group=future_having
ration	group=future_having
reallocate	group=future_having
reassign	group=future_having
vote	group=future_having
will	group=future_having
yield	group=future_having
accord	group=future_having
arrange	group=put
emplace	group=put
immerse	group=put
implant	group=put
lodge	group=put
mount	group=put
position	group=put
situate	group=put
sling	group=put
station	group=put
superimpose	group=put
tack on	group=put
wharf	group=put
apply	group=put
bury	group=put
deposit	group=put
embed	group=put
insert	group=put
install	group=put
park	group=put
plant	group=put
reinstall	group=put
stash	group=put
stow	group=put
place	group=put
put	group=put
set	group=put
stick	group=put
mind	group=care
care	group=care
worry	group=care
wonder	group=care
banish	group=banish
deport	group=banish
evacuate	group=banish
expel	group=banish
extradite	group=banish
recall	group=banish
recuse	group=banish
remove	group=banish
shanghai	group=banish
boot	group=banish
blow	group=split
break	group=split
cut	group=split
draw	group=split
hack	group=split
hew	group=split
kick	group=split
knock	group=split
pry	group=split
pull	group=split
push	group=split
rip	group=split
roll	group=split
saw	group=split
shove	group=split
slip	group=split
sliver	group=split
snap	group=split
split	group=split
tear	group=split
tug	group=split
yank	group=split
chart	group=transcribe
chronicle	group=transcribe
copy	group=transcribe
document	group=transcribe
duplicate	group=transcribe
film	group=transcribe
forge	group=transcribe
microfilm	group=transcribe
photocopy	group=transcribe
photograph	group=transcribe
record	group=transcribe
tally	group=transcribe
tally up	group=transcribe
tape	group=transcribe
televise	group=transcribe
transcribe	group=transcribe
type	group=transcribe
videotape	group=transcribe
defecate	group=exhale
exhale	group=exhale
hemorrhage	group=exhale
perspire	group=exhale
expectorate	group=exhale
regurgitate	group=exhale
urinate	group=exhale
whiff	group=exhale
inhale	group=exhale
rely	group=rely
depend	group=rely
bank	group=rely
bargain	group=rely
count	group=rely
figure	group=rely
reckon	group=rely
bet	group=rely
gamble	group=rely
take a_chance	group=rely
wager	group=rely
balance	group=spatial_configuration
bend	group=spatial_configuration
bow	group=spatial_configuration
crouch	group=spatial_configuration
dangle	group=spatial_configuration
droop	group=spatial_configuration
flop	group=spatial_configuration
fly	group=spatial_configuration
hang	group=spatial_configuration
hover	group=spatial_configuration
huddle	group=spatial_configuration
hunch	group=spatial_configuration
jut	group=spatial_configuration
kneel	group=spatial_configuration
lean	group=spatial_configuration
lie	group=spatial_configuration
loll	group=spatial_configuration
loom	group=spatial_configuration
lounge	group=spatial_configuration
nestle	group=spatial_configuration
open	group=spatial_configuration
perch	group=spatial_configuration
plop	group=spatial_configuration
project	group=spatial_configuration
protrude	group=spatial_configuration
recline	group=spatial_configuration
repose	group=spatial_configuration
rest	group=spatial_configuration
rise	group=spatial_configuration
roost	group=spatial_configuration
sag	group=spatial_configuration
sit	group=spatial_configuration
slope	group=spatial_configuration
slouch	group=spatial_configuration
slump	group=spatial_configuration
sprawl	group=spatial_configuration
squat	group=spatial_configuration
stand	group=spatial_configuration
stoop	group=spatial_configuration
straddle	group=spatial_configuration
swag	group=spatial_configuration
swing	group=spatial_configuration
tilt	group=spatial_configuration
tower	group=spatial_configuration
yaw	group=spatial_configuration
overcome	group=exceed
overleap	group=exceed
transcend	group=exceed
better	group=exceed
exceed	group=exceed
lap	group=exceed
outbid	group=exceed
outdo	group=exceed
outmatch	group=exceed
outnumber	group=exceed
outrace	group=exceed
outshine	group=exceed
outsmart	group=exceed
outstrip	group=exceed
outweigh	group=exceed
outwit	group=exceed
overreach	group=exceed
overstep	group=exceed
surpass	group=exceed
top	group=exceed
cleanse	group=groom
curry	group=groom
groom	group=groom
neaten	group=groom
promote	group=promote
advance	group=promote
boost	group=promote
further	group=promote
encourage	group=promote
invite	group=promote
emphasize	group=promote
underscore	group=promote
consume	group=devour
devour	group=devour
down	group=devour
have	group=devour
ingest	group=devour
smoke	group=devour
imbibe	group=devour
swill	group=devour
call	group=dub
decree	group=dub
dub	group=dub
make	group=dub
pronounce	group=dub
rename	group=dub
rule	group=dub
stamp	group=dub
term	group=dub
vote	group=dub
anoint	group=dub
baptize	group=dub
brand	group=dub
christen	group=dub
consecrate	group=dub
crown	group=dub
label	group=dub
name	group=dub
nickname	group=dub
style	group=dub
classify	group=classify
class	group=classify
constellate	group=classify
sort	group=classify
isolate	group=classify
reclassify	group=classify
group	group=classify
regroup	group=classify
bracket	group=classify
lump	group=classify
chunk	group=classify
grade	group=classify
number	group=classify
catalogue	group=classify
sort out	group=classify
separate	group=classify
seed	group=classify
categorize	group=classify
code	group=classify
recode	group=classify
apostatize	group=entity_specific_cos
atrophy	group=entity_specific_cos
blister	group=entity_specific_cos
bloom	group=entity_specific_cos
blossom	group=entity_specific_cos
bud	group=entity_specific_cos
burgeon	group=entity_specific_cos
burn	group=entity_specific_cos
corrode	group=entity_specific_cos
crust	group=entity_specific_cos
decay	group=entity_specific_cos
decompose	group=entity_specific_cos
deteriorate	group=entity_specific_cos
erode	group=entity_specific_cos
ferment	group=entity_specific_cos
fester	group=entity_specific_cos
flower	group=entity_specific_cos
foliate	group=entity_specific_cos
germinate	group=entity_specific_cos
green	group=entity_specific_cos
molder	group=entity_specific_cos
molt	group=entity_specific_cos
moult	group=entity_specific_cos
oxidize	group=entity_specific_cos
phosphoresce	group=entity_specific_cos
putrefy	group=entity_specific_cos
rot	group=entity_specific_cos
rust	group=entity_specific_cos
spoil	group=entity_specific_cos
sprout	group=entity_specific_cos
stagnate	group=entity_specific_cos
subside	group=entity_specific_cos
suppurate	group=entity_specific_cos
swell	group=entity_specific_cos
tarnish	group=entity_specific_cos
wane	group=entity_specific_cos
wilt	group=entity_specific_cos
wither	group=entity_specific_cos
pullulate	group=entity_specific_cos
imply	group=indicate
predict	group=indicate
denote	group=indicate
corroborate	group=indicate
expose	group=indicate
prognosticate	group=indicate
forebode	group=indicate
anticipate	group=indicate
explain	group=indicate
indicate	group=indicate
say	group=indicate
affirm	group=indicate
reaffirm	group=indicate
disclose	group=indicate
verify	group=indicate
confirm	group=indicate
demonstrate	group=indicate
establish	group=indicate
prove	group=indicate
reveal	group=indicate
show	group=indicate
overload	group=spray
baste	group=spray
brush	group=spray
drizzle	group=spray
hang	group=spray
plaster	group=spray
pump	group=spray
rub	group=spray
scatter	group=spray
seed	group=spray
sew	group=spray
shower	group=spray
smear	group=spray
smudge	group=spray
sow	group=spray
spatter	group=spray
splash	group=spray
splatter	group=spray
spray	group=spray
spread	group=spray
sprinkle	group=spray
spritz	group=spray
squirt	group=spray
stick	group=spray
strew	group=spray
string	group=spray
swab	group=spray
swash	group=spray
spurt	group=spray
wrap	group=spray
cram	group=spray
crowd	group=spray
jam	group=spray
pack	group=spray
pile	group=spray
drape	group=spray
load	group=spray
dab	group=spray
daub	group=spray
mound	group=spray
dust	group=spray
heap	group=spray
plant	group=spray
seed	group=spray
slather	group=spray
stack	group=spray
stock	group=spray
stuff	group=spray
bend	group=bend
crease	group=bend
crinkle	group=bend
crumple	group=bend
distend	group=bend
flex	group=bend
fold	group=bend
furrow	group=bend
hyperextend	group=bend
roll	group=bend
round	group=bend
rumple	group=bend
scrunch	group=bend
splay	group=bend
straighten	group=bend
stretch	group=bend
unfold	group=bend
unfurl	group=bend
unroll	group=bend
unwind	group=bend
warp	group=bend
wrinkle	group=bend
unbend	group=bend
ball	group=knead
beat	group=knead
bend	group=knead
coil	group=knead
collect	group=knead
compress	group=knead
contort	group=knead
curve	group=knead
distort	group=knead
fold	group=knead
flex	group=knead
flux	group=knead
knead	group=knead
melt	group=knead
shake	group=knead
squash	group=knead
squeeze	group=knead
squish	group=knead
twirl	group=knead
twist	group=knead
wad	group=knead
whip	group=knead
wind	group=knead
work	group=knead
bake	group=preparing
blend	group=preparing
brew	group=preparing
clear	group=preparing
cook	group=preparing
cook up	group=preparing
fix	group=preparing
invent	group=preparing
kindle	group=preparing
light	group=preparing
mix	group=preparing
prepare	group=preparing
ready	group=preparing
roll	group=preparing
run	group=preparing
toss	group=preparing
cultivate	group=preparing
barbeque	group=preparing
barbecue	group=preparing
boil	group=preparing
broil	group=preparing
clean	group=preparing
fry	group=preparing
grill	group=preparing
hardboil	group=preparing
iron	group=preparing
microwave	group=preparing
overbake	group=preparing
poach	group=preparing
pour	group=preparing
roast	group=preparing
scramble	group=preparing
set	group=preparing
softboil	group=preparing
toast	group=preparing
wash	group=preparing
weld	group=preparing
accomplish	group=complete
achieve	group=complete
complete	group=complete
discontinue	group=complete
quit	group=complete
spend	group=pay
squander	group=pay
waste	group=pay
serve	group=pay
tithe	group=pay
pay	group=pay
repay	group=pay
charge	group=confine
institutionalize	group=confine
incarcerate	group=confine
hospitalize	group=confine
detain	group=confine
jail	group=confine
imprison	group=confine
jug	group=confine
hold	group=confine
immure	group=confine
commit	group=confine
recommit	group=confine
send	group=confine
confine	group=confine
ferret	group=ferret
nose	group=ferret
tease	group=ferret
banter	group=correspond
bargain	group=correspond
coexist	group=correspond
collaborate	group=correspond
collide	group=correspond
commiserate	group=correspond
communicate	group=correspond
compromise	group=correspond
cohabit	group=correspond
concur	group=correspond
confabulate	group=correspond
confer	group=correspond
consort	group=correspond
cooperate	group=correspond
correspond	group=correspond
decide	group=correspond
deliberate	group=correspond
dissent	group=correspond
disagree	group=correspond
flirt	group=correspond
haggle	group=correspond
hobnob	group=correspond
interact	group=correspond
intermix	group=correspond
mate	group=correspond
mingle	group=correspond
mix	group=correspond
neck	group=correspond
negotiate	group=correspond
parley	group=correspond
plot	group=correspond
rendezvous	group=correspond
renegotiate	group=correspond
reunite	group=correspond
spoon	group=correspond
agree	group=correspond
debate	group=correspond
argue	group=correspond
advertise	group=search
check	group=search
comb	group=search
dive	group=search
drag	group=search
dredge	group=search
excavate	group=search
nose	group=search
patrol	group=search
plumb	group=search
probe	group=search
prospect	group=search
prowl	group=search
quarry	group=search
rake	group=search
rifle	group=search
scavenge	group=search
scour	group=search
scout	group=search
search	group=search
shop	group=search
sift	group=search
sweep	group=search
trawl	group=search
troll	group=search
watch	group=search
quest	group=search
amerce	group=bill
bet	group=bill
bill	group=bill
charge	group=bill
fine	group=bill
invoice	group=bill
mulct	group=bill
overcharge	group=bill
save	group=bill
scrimp	group=bill
spare	group=bill
tax	group=bill
tip	group=bill
undercharge	group=bill
wager	group=bill
catnap	group=snooze
doze	group=snooze
drowse	group=snooze
nap	group=snooze
sleep	group=snooze
slumber	group=snooze
snooze	group=snooze
reach	group=reach
hit	group=reach
make	group=reach
breast	group=reach
echo	group=sound_existence
resonate	group=sound_existence
resound	group=sound_existence
reverberate	group=sound_existence
roll	group=sound_existence
sound	group=sound_existence
color	group=coloring
distemper	group=coloring
dye	group=coloring
enamel	group=coloring
glaze	group=coloring
japan	group=coloring
lacquer	group=coloring
paint	group=coloring
repaint	group=coloring
shellac	group=coloring
spraypaint	group=coloring
stain	group=coloring
starch	group=coloring
tint	group=coloring
varnish	group=coloring
collaborate	group=cooperate
cooperate	group=cooperate
join	group=cooperate
participate	group=cooperate
labour	group=cooperate
work	group=cooperate
back out	group=withdraw
chicken out	group=withdraw
get out	group=withdraw
wriggle out	group=withdraw
bow out	group=withdraw
pull out	group=withdraw
get away	group=withdraw
back off	group=withdraw
withdraw	group=withdraw
retreat	group=withdraw
pull away	group=withdraw
retire	group=withdraw
ache	group=long
crave	group=long
fall	group=long
hanker	group=long
hope	group=long
hunger	group=long
itch	group=long
long	group=long
lust	group=long
pine	group=long
pray	group=long
thirst	group=long
wish	group=long
yearn	group=long
dangle	group=long
hanker	group=long
lust	group=long
thirst	group=long
yearn	group=long
balloon	group=vehicle
boat	group=vehicle
bobsled	group=vehicle
bus	group=vehicle
cab	group=vehicle
caravan	group=vehicle
chariot	group=vehicle
coach	group=vehicle
dogsled	group=vehicle
ferry	group=vehicle
gondola	group=vehicle
helicopter	group=vehicle
jeep	group=vehicle
jet	group=vehicle
moped	group=vehicle
motor	group=vehicle
parachute	group=vehicle
punt	group=vehicle
rickshaw	group=vehicle
rocket	group=vehicle
sledge	group=vehicle
sleigh	group=vehicle
taxi	group=vehicle
tram	group=vehicle
trolley	group=vehicle
yacht	group=vehicle
bicycle	group=vehicle
bike	group=vehicle
canoe	group=vehicle
cycle	group=vehicle
kayak	group=vehicle
motorbike	group=vehicle
motorcycle	group=vehicle
raft	group=vehicle
skate	group=vehicle
skateboard	group=vehicle
ski	group=vehicle
sled	group=vehicle
toboggan	group=vehicle
apprentice	group=orphan
beggar	group=orphan
cripple	group=orphan
cuckold	group=orphan
knight	group=orphan
martyr	group=orphan
orphan	group=orphan
outlaw	group=orphan
pauper	group=orphan
recruit	group=orphan
whore	group=orphan
widow	group=orphan
carve	group=disassemble
detach	group=disassemble
disassemble	group=disassemble
disconnect	group=disassemble
dismantle	group=disassemble
dismount	group=disassemble
pare	group=disassemble
partition	group=disassemble
segregate	group=disassemble
sift	group=disassemble
slice	group=disassemble
sunder	group=disassemble
unbolt	group=disassemble
unbuckle	group=disassemble
unbutton	group=disassemble
unchain	group=disassemble
unclamp	group=disassemble
unclasp	group=disassemble
unclip	group=disassemble
unfasten	group=disassemble
unfix	group=disassemble
unglue	group=disassemble
unhinge	group=disassemble
unhitch	group=disassemble
unhook	group=disassemble
unlace	group=disassemble
unlatch	group=disassemble
unlock	group=disassemble
unleash	group=disassemble
unpeg	group=disassemble
unpin	group=disassemble
unscrew	group=disassemble
unseal	group=disassemble
unshackle	group=disassemble
unstaple	group=disassemble
unstitch	group=disassemble
untie	group=disassemble
unzip	group=disassemble
sieve	group=disassemble
suspect	group=suspect
accuse	group=suspect
condemn	group=suspect
deduce	group=discover
determine	group=discover
discover	group=discover
find	group=discover
guess	group=discover
realize	group=discover
ascertain	group=discover
rationalize	group=discover
relearn	group=discover
scent out	group=discover
solve	group=discover
chance across	group=discover
chance on	group=discover
pick up	group=discover
hear	group=discover
learn	group=discover
read	group=discover
study	group=discover
find out	group=discover
figure out	group=discover
lecture	group=lecture
moralize	group=lecture
preach	group=lecture
rant	group=lecture
remark	group=lecture
speak	group=lecture
talk	group=lecture
testify	group=lecture
theorize	group=lecture
write	group=lecture
pontificate	group=lecture
elaborate	group=lecture
comment	group=lecture
dwell	group=lecture
empathize	group=empathize
sympathize	group=empathize
identify	group=empathize
commiserate	group=empathize
doll	group=dressing_well
dress	group=dressing_well
gussy	group=dressing_well
spruce	group=dressing_well
tog	group=dressing_well
trick	group=dressing_well
beam	group=light_emission
blaze	group=light_emission
blink	group=light_emission
burn	group=light_emission
flame	group=light_emission
flare	group=light_emission
flash	group=light_emission
flicker	group=light_emission
fluoresce	group=light_emission
glare	group=light_emission
gleam	group=light_emission
glimmer	group=light_emission
glint	group=light_emission
glisten	group=light_emission
glitter	group=light_emission
glow	group=light_emission
incandesce	group=light_emission
scintillate	group=light_emission
shimmer	group=light_emission
shine	group=light_emission
sparkle	group=light_emission
twinkle	group=light_emission
copyright	group=patent
patent	group=patent
trademark	group=patent
license	group=patent
register	group=patent
certify	group=patent
credential	group=patent
accredit	group=patent
verify	group=patent
evidence	group=patent
imitate	group=patent
impersonate	group=patent
support	group=help
succor	group=help
aid	group=help
abet	group=help
assist	group=help
help	group=help
convey	group=send
deliver	group=send
dispatch	group=send
handdeliver	group=send
pass on	group=send
port	group=send
post	group=send
return	group=send
shift	group=send
shunt	group=send
transfer	group=send
transport	group=send
export	group=send
import	group=send
transship	group=send
airmail	group=send
express	group=send
FedEx	group=send
forward	group=send
hand	group=send
mail	group=send
pass	group=send
send	group=send
ship	group=send
slip	group=send
smuggle	group=send
sneak	group=send
transmit	group=send
UPS	group=send
wire	group=send
die	group=disappearance
disappear	group=disappearance
expire	group=disappearance
lapse	group=disappearance
perish	group=disappearance
vanish	group=disappearance
abandon	group=leave
split	group=leave
desert	group=leave
leave	group=leave
niggle	group=appeal
grate	group=appeal
jar	group=appeal
appeal	group=appeal
matter	group=appeal
bore	group=rummage
burrow	group=rummage
fumble	group=rummage
leaf	group=rummage
listen	group=rummage
look	group=rummage
page	group=rummage
poke	group=rummage
scrabble	group=rummage
scratch	group=rummage
forage	group=rummage
grope	group=rummage
rifle	group=rummage
rummage	group=rummage
paw	group=rummage
delve	group=rummage
root	group=rummage
thumb	group=rummage
snoop	group=rummage
tunnel	group=rummage
carry	group=fit
contain	group=fit
fit	group=fit
feed	group=fit
hibernate	group=fit
hold	group=fit
house	group=fit
reseat	group=fit
seat	group=fit
serve	group=fit
sleep	group=fit
store	group=fit
take	group=fit
use	group=fit
arrange	group=build
assemble	group=build
bake	group=build
bead	group=build
blow	group=build
cast	group=build
chisel	group=build
churn	group=build
compile	group=build
cook	group=build
crochet	group=build
develop	group=build
embroider	group=build
erect	group=build
fashion	group=build
fold	group=build
forge	group=build
formulate	group=build
grind	group=build
grow	group=build
hack	group=build
hammer	group=build
knit	group=build
mold	group=build
pound	group=build
reassemble	group=build
refashion	group=build
roll	group=build
sculpture	group=build
sew	group=build
spin	group=build
stitch	group=build
weave	group=build
whittle	group=build
build	group=build
carve	group=build
cut	group=build
make	group=build
remake	group=build
sculpt	group=build
shape	group=build
bike	group=drive
drive	group=drive
row	group=drive
motor	group=drive
paddle	group=drive
tool	group=drive
tool around	group=drive
trundle	group=drive
wheel	group=drive
barge	group=drive
bus	group=drive
cart	group=drive
ferry	group=drive
fly	group=drive
shuttle	group=drive
truck	group=drive
clasp	group=hold
clutch	group=hold
grab	group=hold
grasp	group=hold
grip	group=hold
handle	group=hold
hold	group=hold
pull	group=hold
push	group=hold
seize	group=hold
tug	group=hold
wield	group=hold
yank	group=hold
pass	group=spend_time
serve	group=spend_time
carry	group=carry
drag	group=carry
draw	group=carry
haul	group=carry
heft	group=carry
hoist	group=carry
lug	group=carry
nudge	group=carry
pull	group=carry
run	group=carry
schlep	group=carry
tote	group=carry
tow	group=carry
tug	group=carry
yank	group=carry
heave	group=carry
kick	group=carry
push	group=carry
shove	group=carry
thrust	group=carry
maintain	group=sustain
sustain	group=sustain
prolong	group=sustain
protract	group=sustain
keep	group=sustain
keep up	group=sustain
continue	group=sustain
carry on	group=sustain
wag	group=wink
beckon	group=wink
blink	group=wink
clap	group=wink
gesture	group=wink
nod	group=wink
point	group=wink
shrug	group=wink
squint	group=wink
wave	group=wink
wink	group=wink
rehearse	group=rehearse
practice	group=rehearse
walk through	group=rehearse
exercise	group=rehearse
repeat	group=rehearse
bruise	group=carve
chip	group=carve
cleave	group=carve
crumble	group=carve
crumple	group=carve
crunch	group=carve
crush	group=carve
cube	group=carve
dent	group=carve
dice	group=carve
fillet	group=carve
flake	group=carve
flatten	group=carve
gash	group=carve
gouge	group=carve
grate	group=carve
grind	group=carve
mangle	group=carve
mash	group=carve
mince	group=carve
nick	group=carve
notch	group=carve
perforate	group=carve
pulverize	group=carve
quarter	group=carve
scollop	group=carve
scrunch	group=carve
shred	group=carve
slice	group=carve
slit	group=carve
smash	group=carve
squash	group=carve
squish	group=carve
trench	group=carve
bore	group=carve
carve	group=carve
chop	group=carve
crop	group=carve
crumb	group=carve
drill	group=carve
file	group=carve
lance	group=carve
mill	group=carve
mangle	group=carve
mow	group=carve
pink	group=carve
punch	group=carve
prune	group=carve
scollop	group=carve
sand	group=carve
spear	group=carve
tool	group=carve
tread	group=carve
cruise	group=nonvehicle
drive	group=nonvehicle
fly	group=nonvehicle
navigate	group=nonvehicle
oar	group=nonvehicle
paddle	group=nonvehicle
pedal	group=nonvehicle
rally	group=nonvehicle
ride	group=nonvehicle
row	group=nonvehicle
sail	group=nonvehicle
tack	group=nonvehicle
voyage	group=nonvehicle
wing	group=nonvehicle
disenfranchise	group=subjugate
enslave	group=subjugate
mob	group=subjugate
nourish	group=subjugate
suppress	group=subjugate
stamp down	group=subjugate
subdue	group=subjugate
conquer	group=subjugate
curb	group=subjugate
crush	group=subjugate
stifle	group=subjugate
dampen	group=subjugate
suffocate	group=subjugate
choke	group=subjugate
hush	group=subjugate
silence	group=subjugate
still	group=subjugate
shut up	group=subjugate
hush up	group=subjugate
lull	group=subjugate
calm down	group=subjugate
gag	group=subjugate
muzzle	group=subjugate
squelch	group=subjugate
quell	group=subjugate
quench	group=subjugate
smother	group=subjugate
muffle	group=subjugate
repress	group=subjugate
quash	group=subjugate
keep down	group=subjugate
subjugate	group=subjugate
reduce	group=subjugate
slake	group=subjugate
strangle	group=subjugate
kill	group=subjugate
belt	group=performance
chant	group=performance
direct	group=performance
enact	group=performance
improvise	group=performance
intone	group=performance
perform	group=performance
vocalize	group=performance
scriptwrite	group=performance
dance	group=performance
hum	group=performance
play	group=performance
recite	group=performance
rap	group=performance
sing	group=performance
whistle	group=performance
heel	group=performance
choreograph	group=performance
compose	group=performance
produce	group=performance
silkscreen	group=performance
take	group=performance
draw	group=performance
paint	group=performance
replay	group=performance
spin	group=performance
write	group=performance
feel	group=stimulus_subject
look	group=stimulus_subject
smell	group=stimulus_subject
sound	group=stimulus_subject
taste	group=stimulus_subject
avoid	group=avoid
boycott	group=avoid
circumvent	group=avoid
dodge	group=avoid
duck	group=avoid
elude	group=avoid
eschew	group=avoid
evade	group=avoid
forgo	group=avoid
shun	group=avoid
sidestep	group=avoid
caress	group=touch
fondle	group=touch
grasp	group=touch
graze	group=touch
grip	group=touch
grope	group=touch
kiss	group=touch
knead	group=touch
lick	group=touch
massage	group=touch
nudge	group=touch
osculate	group=touch
pat	group=touch
paw	group=touch
peck	group=touch
pet	group=touch
pinch	group=touch
prod	group=touch
rub	group=touch
squeeze	group=touch
sting	group=touch
stroke	group=touch
tickle	group=touch
touch	group=touch
tug	group=touch
tweak	group=touch
twinge	group=touch
wring	group=touch
chafe	group=touch
acclaim	group=judgment
accurse	group=judgment
applaud	group=judgment
assail	group=judgment
assault	group=judgment
attack	group=judgment
badmouth	group=judgment
belittle	group=judgment
blame	group=judgment
blaspheme	group=judgment
bless	group=judgment
celebrate	group=judgment
commend	group=judgment
compensate	group=judgment
compliment	group=judgment
condone	group=judgment
congratulate	group=judgment
curse	group=judgment
damn	group=judgment
doubt	group=judgment
eulogize	group=judgment
excoriate	group=judgment
excuse	group=judgment
extol	group=judgment
felicitate	group=judgment
forgive	group=judgment
gibe	group=judgment
glorify	group=judgment
greet	group=judgment
hail	group=judgment
herald	group=judgment
imprecate	group=judgment
incriminate	group=judgment
indict	group=judgment
lampoon	group=judgment
stigmatize	group=judgment
praise	group=judgment
honor	group=judgment
recommend	group=judgment
laud	group=judgment
pardon	group=judgment
recompense	group=judgment
remunerate	group=judgment
reprobate	group=judgment
slander	group=judgment
stultify	group=judgment
repay	group=judgment
reward	group=judgment
salute	group=judgment
satirize	group=judgment
thank	group=judgment
toast	group=judgment
welcome	group=judgment
abuse	group=judgment
backbite	group=judgment
calumniate	group=judgment
castigate	group=judgment
censure	group=judgment
chasten	group=judgment
chastise	group=judgment
chide	group=judgment
condemn	group=judgment
criticize	group=judgment
decry	group=judgment
defame	group=judgment
denigrate	group=judgment
denounce	group=judgment
deprecate	group=judgment
deride	group=judgment
disparage	group=judgment
fault	group=judgment
impeach	group=judgment
insult	group=judgment
lambaste	group=judgment
malign	group=judgment
mock	group=judgment
penalize	group=judgment
persecute	group=judgment
prosecute	group=judgment
punish	group=judgment
rebuke	group=judgment
reprimand	group=judgment
reproach	group=judgment
reprove	group=judgment
revile	group=judgment
ridicule	group=judgment
scold	group=judgment
repudiate	group=judgment
scorn	group=judgment
shame	group=judgment
snub	group=judgment
upbraid	group=judgment
victimize	group=judgment
vilify	group=judgment
approve	group=judgment
sanction	group=judgment
slang	group=judgment
dig	group=poke
jab	group=poke
pierce	group=poke
poke	group=poke
prick	group=poke
stab	group=poke
stick	group=poke
multiply	group=calibratable_cos
advance	group=calibratable_cos
appreciate	group=calibratable_cos
balloon	group=calibratable_cos
climb	group=calibratable_cos
decline	group=calibratable_cos
decrease	group=calibratable_cos
depreciate	group=calibratable_cos
diminish	group=calibratable_cos
drop	group=calibratable_cos
dwindle	group=calibratable_cos
explode	group=calibratable_cos
fall	group=calibratable_cos
fluctuate	group=calibratable_cos
gain	group=calibratable_cos
grow	group=calibratable_cos
increase	group=calibratable_cos
jump	group=calibratable_cos
move	group=calibratable_cos
mushroom	group=calibratable_cos
plummet	group=calibratable_cos
plump	group=calibratable_cos
plunge	group=calibratable_cos
retreat	group=calibratable_cos
rocket	group=calibratable_cos
rise	group=calibratable_cos
seesaw	group=calibratable_cos
shift	group=calibratable_cos
skyrocket	group=calibratable_cos
slide	group=calibratable_cos
slip	group=calibratable_cos
soar	group=calibratable_cos
surge	group=calibratable_cos
swing	group=calibratable_cos
tumble	group=calibratable_cos
vary	group=calibratable_cos
dip	group=calibratable_cos
lower	group=calibratable_cos
swell	group=calibratable_cos
ensure	group=ensure
assure	group=ensure
guarantee	group=ensure
insure	group=ensure
secure	group=ensure
ascertain	group=ensure
reinsure	group=ensure
constitute	group=establish
constitutionalize	group=establish
innovate	group=establish
machinate	group=establish
pioneer	group=establish
stage	group=establish
initiate	group=establish
establish	group=establish
fake	group=establish
feign	group=establish
format	group=establish
found	group=establish
plant	group=establish
implement	group=establish
instigate	group=establish
institute	group=establish
organize	group=establish
originate	group=establish
prepare	group=establish
premise	group=establish
devise	group=establish
mount	group=establish
bring about	group=establish
arrange	group=establish
introduce	group=establish
simulate	group=establish
strike up	group=establish
synthesise	group=establish
launch	group=establish
open	group=establish
open up	group=establish
bristle	group=bulge
bulge	group=bulge
buzz	group=bulge
hum	group=bulge
hyperventilate	group=bulge
seethe	group=bulge
abolish	group=remove
abstract	group=remove
cull	group=remove
deburr	group=remove
deduct	group=remove
delete	group=remove
depose	group=remove
disgorge	group=remove
dislodge	group=remove
disengage	group=remove
draw	group=remove
eject	group=remove
eliminate	group=remove
eradicate	group=remove
excise	group=remove
excommunicate	group=remove
expel	group=remove
extirpate	group=remove
extract	group=remove
extrude	group=remove
lop	group=remove
omit	group=remove
ostracize	group=remove
partition	group=remove
pry	group=remove
reap	group=remove
ream	group=remove
retract	group=remove
roust	group=remove
separate	group=remove
shoo	group=remove
subtract	group=remove
uproot	group=remove
winkle	group=remove
wrench	group=remove
withdraw	group=remove
oust	group=remove
discharge	group=remove
dismiss	group=remove
evict	group=remove
remove	group=remove
sever	group=remove
extinguish	group=remove
prise	group=remove
lump	group=shake
mass	group=shake
beat	group=shake
fuse	group=shake
scramble	group=shake
stir	group=shake
swirl	group=shake
whip	group=shake
whisk	group=shake
band	group=shake
baste	group=shake
cluster	group=shake
collate	group=shake
collect	group=shake
fix	group=shake
gather	group=shake
glom	group=shake
group	group=shake
herd	group=shake
pair	group=shake
roll	group=shake
sew	group=shake
shake	group=shake
shuffle	group=shake
stick	group=shake
attach	group=shake
bind	group=shake
bond	group=shake
bundle	group=shake
concatenate	group=shake
fasten	group=shake
graft	group=shake
jumble	group=shake
ligate	group=shake
moor	group=shake
package	group=shake
secure	group=shake
splice	group=shake
toggle	group=shake
weld	group=shake
fixate	group=shake
affix	group=shake
agglutinate	group=shake
have	group=own
own	group=own
possess	group=own
smell	group=seem
sound	group=seem
taste	group=seem
keep	group=seem
seem	group=seem
take	group=bring
bring	group=bring
ensue	group=occurrence
eventuate	group=occurrence
follow	group=occurrence
happen	group=occurrence
occur	group=occurrence
recur	group=occurrence
result	group=occurrence
take place	group=occurrence
transpire	group=occurrence
befall	group=occurrence
chance	group=occurrence
develop	group=occurrence
pass	group=occurrence
use	group=use
utilize	group=use
apply	group=use
employ	group=use
exert	group=use
exploit	group=use
reuse	group=use
bang	group=hit
bash	group=hit
click	group=hit
dash	group=hit
squash	group=hit
tamp	group=hit
thump	group=hit
thwack	group=hit
whack	group=hit
smite	group=hit
batter	group=hit
beat	group=hit
bump	group=hit
butt	group=hit
drum	group=hit
hammer	group=hit
hit	group=hit
jab	group=hit
kick	group=hit
knock	group=hit
lash	group=hit
pound	group=hit
rap	group=hit
slap	group=hit
smack	group=hit
smash	group=hit
strike	group=hit
stomp	group=hit
whang	group=hit
tap	group=hit
estimate	group=estimate
gauge	group=estimate
approximate	group=estimate
guess	group=estimate
judge	group=estimate
count	group=estimate
quantize	group=estimate
assess	group=estimate
guesstimate	group=estimate
project	group=estimate
asphyxiate	group=poison
behead	group=poison
bullet	group=poison
crucify	group=poison
dart	group=poison
decapitate	group=poison
disembowel	group=poison
drown	group=poison
electrocute	group=poison
evicerate	group=poison
gas	group=poison
garrotte	group=poison
hang	group=poison
impale	group=poison
knife	group=poison
poison	group=poison
shoot	group=poison
smother	group=poison
stab	group=poison
stone	group=poison
strangle	group=poison
strangulate	group=poison
suffocate	group=poison
throttle	group=poison
dig	group=hunt
feel	group=hunt
fish	group=hunt
hunt	group=hunt
mine	group=hunt
pan	group=hunt
poach	group=hunt
scrounge	group=hunt
seek	group=hunt
involve	group=relate
concern	group=relate
touch	group=relate
bear on	group=relate
touch on	group=relate
refer	group=relate
pertain	group=relate
relate	group=relate
attire	group=being_dressed
clad	group=being_dressed
garb	group=being_dressed
outfit	group=being_dressed
robe	group=being_dressed
aromatize	group=butter
asphalt	group=butter
bait	group=butter
black	group=butter
blanket	group=butter
blindfold	group=butter
board	group=butter
bread	group=butter
brick	group=butter
bridle	group=butter
bronze	group=butter
butter	group=butter
buttonhole	group=butter
calk	group=butter
camouflage	group=butter
cap	group=butter
carpet	group=butter
caulk	group=butter
chrome	group=butter
clay	group=butter
cloak	group=butter
coal	group=butter
cork	group=butter
crown	group=butter
crumb	group=butter
diaper	group=butter
dope	group=butter
drug	group=butter
feather	group=butter
fence	group=butter
flour	group=butter
forest	group=butter
frame	group=butter
frost	group=butter
fuel	group=butter
glaze	group=butter
gag	group=butter
garland	group=butter
gas	group=butter
glass	group=butter
glove	group=butter
graffiti	group=butter
grass	group=butter
gravel	group=butter
grease	group=butter
groove	group=butter
halter	group=butter
harness	group=butter
hat	group=butter
heel	group=butter
ice	group=butter
ink	group=butter
label	group=butter
leash	group=butter
leaven	group=butter
lipstick	group=butter
lubricate	group=butter
mantle	group=butter
mulch	group=butter
muzzle	group=butter
nickel	group=butter
oil	group=butter
ornament	group=butter
paint	group=butter
panel	group=butter
paper	group=butter
parquet	group=butter
patch	group=butter
pepper	group=butter
perfume	group=butter
plank	group=butter
plaster	group=butter
poison	group=butter
polish	group=butter
pomade	group=butter
poster	group=butter
postmark	group=butter
powder	group=butter
punctuate	group=butter
putty	group=butter
robe	group=butter
roof	group=butter
rosin	group=butter
rouge	group=butter
rut	group=butter
saddle	group=butter
salt	group=butter
salve	group=butter
sand	group=butter
scent	group=butter
seed	group=butter
sequin	group=butter
shawl	group=butter
shingle	group=butter
shoe	group=butter
shutter	group=butter
side	group=butter
silver	group=butter
slate	group=butter
slime	group=butter
slipcover	group=butter
sod	group=butter
soil	group=butter
sole	group=butter
spice	group=butter
stain	group=butter
starch	group=butter
stopper	group=butter
stress	group=butter
string	group=butter
stucco	group=butter
sugar	group=butter
sulphur	group=butter
tag	group=butter
tar	group=butter
tarmac	group=butter
tassel	group=butter
thatch	group=butter
ticket	group=butter
tile	group=butter
tinsel	group=butter
top	group=butter
turf	group=butter
varnish	group=butter
veil	group=butter
veneer	group=butter
wallpaper	group=butter
water	group=butter
wax	group=butter
wharf	group=butter
whitewash	group=butter
wreathe	group=butter
yoke	group=butter
zipcode	group=butter
insulate	group=butter
sauce	group=butter
alter	group=turn
deform	group=turn
metamorphose	group=turn
morph	group=turn
mutate	group=turn
transform	group=turn
translate	group=turn
transmute	group=turn
change	group=turn
convert	group=turn
turn	group=turn
coin	group=create
compose	group=create
compute	group=create
concoct	group=create
construct	group=create
contrive	group=create
cowrite	group=create
create	group=create
derive	group=create
fabricate	group=create
form	group=create
formulate	group=create
improvise	group=create
invent	group=create
manufacture	group=create
mass-produce	group=create
model	group=create
organize	group=create
produce	group=create
recreate	group=create
rebuild	group=create
style	group=create
synthesize	group=create
lay	group=create
author	group=create
draft	group=create
write	group=create
piece together	group=create
conjure	group=create
craft	group=create
design	group=create
dig	group=create
mint	group=create
publish	group=create
rearrange	group=create
reconstitute	group=create
reorganize	group=create
schedule	group=create
stage	group=create
chip	group=cut
chop	group=cut
clip	group=cut
cut	group=cut
hack	group=cut
hew	group=cut
rip	group=cut
saw	group=cut
scarify	group=cut
scrape	group=cut
scratch	group=cut
slash	group=cut
slice	group=cut
snip	group=cut
ream	group=cut
clock	group=register
time	group=register
mistime	group=register
measure	group=register
read	group=register
register	group=register
total	group=register
weigh	group=register
blow	group=weather
bucket	group=weather
clear	group=weather
drizzle	group=weather
fog	group=weather
frost	group=weather
freeze	group=weather
gust	group=weather
hail	group=weather
howl	group=weather
lightning	group=weather
mist	group=weather
mizzle	group=weather
pelt	group=weather
pour	group=weather
precipitate	group=weather
rain	group=weather
roar	group=weather
shower	group=weather
sleet	group=weather
snow	group=weather
spit	group=weather
spot	group=weather
sprinkle	group=weather
storm	group=weather
swelter	group=weather
teem	group=weather
thaw	group=weather
thunder	group=weather
argue	group=chit_chat
chat	group=chit_chat
chatter	group=chit_chat
chitchat	group=chit_chat
confer	group=chit_chat
converse	group=chit_chat
debate	group=chit_chat
gab	group=chit_chat
gossip	group=chit_chat
jest	group=chit_chat
joke	group=chit_chat
palaver	group=chit_chat
rap	group=chit_chat
schmooze	group=chit_chat
yak	group=chit_chat
brush	group=floss
floss	group=floss
shave	group=floss
wash	group=floss
continue	group=continue
add	group=say
allege	group=say
blabber	group=say
disclose	group=say
divulge	group=say
exclaim	group=say
insinuate	group=say
insist	group=say
intimate	group=say
leak	group=say
reply	group=say
respond	group=say
retort	group=say
promulgate	group=say
utter	group=say
venture	group=say
vocalize	group=say
voice	group=say
volunteer	group=say
write	group=say
advise	group=say
announce	group=say
articulate	group=say
blab	group=say
blurt	group=say
claim	group=say
confess	group=say
confide	group=say
convey	group=say
declare	group=say
interject	group=say
interpose	group=say
mention	group=say
observe	group=say
proclaim	group=say
propose	group=say
recount	group=say
reiterate	group=say
relate	group=say
reveal	group=say
say	group=say
state	group=say
volunteer	group=say
repeat	group=say
remark	group=say
note	group=say
report	group=say
purpose	group=say
suggest	group=say
recommend	group=say
hint	group=say
abate	group=other_cos
abbreviate	group=other_cos
abrade	group=other_cos
abridge	group=other_cos
accelerate	group=other_cos
acetify	group=other_cos
acidify	group=other_cos
activate	group=other_cos
advance	group=other_cos
age	group=other_cos
agglomerate	group=other_cos
air	group=other_cos
alkalify	group=other_cos
alter	group=other_cos
ameliorate	group=other_cos
americanize	group=other_cos
amplify	group=other_cos
anglicize	group=other_cos
atomize	group=other_cos
attenuate	group=other_cos
augment	group=other_cos
balance	group=other_cos
blacken	group=other_cos
beautify	group=other_cos
bifurcate	group=other_cos
bisect	group=other_cos
bleach	group=other_cos
blunt	group=other_cos
blur	group=other_cos
bolshevize	group=other_cos
brighten	group=other_cos
broaden	group=other_cos
burn	group=other_cos
burst	group=other_cos
calcify	group=other_cos
capsize	group=other_cos
caramelize	group=other_cos
carbonize	group=other_cos
centralize	group=other_cos
change	group=other_cos
char	group=other_cos
cheapen	group=other_cos
chill	group=other_cos
civilize	group=other_cos
clarify	group=other_cos
clean	group=other_cos
clear	group=other_cos
clog	group=other_cos
close	group=other_cos
cloud	group=other_cos
coagulate	group=other_cos
coarsen	group=other_cos
collapse	group=other_cos
collect	group=other_cos
combust	group=other_cos
compress	group=other_cos
condense	group=other_cos
congeal	group=other_cos
constrict	group=other_cos
cool	group=other_cos
corrode	group=other_cos
corrugate	group=other_cos
corrupt	group=other_cos
crimson	group=other_cos
crisp	group=other_cos
crumble	group=other_cos
crystallize	group=other_cos
curdle	group=other_cos
dampen	group=other_cos
darken	group=other_cos
de-escalate	group=other_cos
decelerate	group=other_cos
decentralize	group=other_cos
decompress	group=other_cos
decrease	group=other_cos
deepen	group=other_cos
deflate	group=other_cos
defrost	group=other_cos
degenerate	group=other_cos
degrade	group=other_cos
dehydrate	group=other_cos
demagnetize	group=other_cos
democratize	group=other_cos
depressurize	group=other_cos
derail	group=other_cos
desiccate	group=other_cos
destabilize	group=other_cos
deteriorate	group=other_cos
detonate	group=other_cos
devalue	group=other_cos
diffuse	group=other_cos
dilate	group=other_cos
dilute	group=other_cos
dim	group=other_cos
diminish	group=other_cos
dirty	group=other_cos
disintegrate	group=other_cos
disperse	group=other_cos
dissipate	group=other_cos
dissolve	group=other_cos
diversify	group=other_cos
divide	group=other_cos
double	group=other_cos
dull	group=other_cos
ease	group=other_cos
effeminate	group=other_cos
emaciate	group=other_cos
empty	group=other_cos
emulsify	group=other_cos
energize	group=other_cos
enlarge	group=other_cos
equalize	group=other_cos
equilibrate	group=other_cos
evaporate	group=other_cos
even	group=other_cos
explode	group=other_cos
fade	group=other_cos
famish	group=other_cos
fatten	group=other_cos
federate	group=other_cos
feminize	group=other_cos
fill	group=other_cos
firm	group=other_cos
flatten	group=other_cos
flood	group=other_cos
fray	group=other_cos
frost	group=other_cos
fructify	group=other_cos
fuse	group=other_cos
gasify	group=other_cos
gelatinize	group=other_cos
germanize	group=other_cos
gladden	group=other_cos
glutenize	group=other_cos
granulate	group=other_cos
gray	group=other_cos
grow	group=other_cos
halt	group=other_cos
harden	group=other_cos
harmonize	group=other_cos
hasten	group=other_cos
heal	group=other_cos
heat	group=other_cos
heighten	group=other_cos
hellenize	group=other_cos
hush	group=other_cos
hybridize	group=other_cos
hydrate	group=other_cos
ignite	group=other_cos
improve	group=other_cos
increase	group=other_cos
incubate	group=other_cos
indurate	group=other_cos
inflate	group=other_cos
intensify	group=other_cos
ionize	group=other_cos
kindle	group=other_cos
laminate	group=other_cos
lengthen	group=other_cos
lessen	group=other_cos
level	group=other_cos
levitate	group=other_cos
lignify	group=other_cos
liquefy	group=other_cos
liquify	group=other_cos
loop	group=other_cos
loose	group=other_cos
loosen	group=other_cos
macerate	group=other_cos
mature	group=other_cos
mellow	group=other_cos
mobilize	group=other_cos
moderate	group=other_cos
modernize	group=other_cos
modulate	group=other_cos
moisten	group=other_cos
multiply	group=other_cos
narrow	group=other_cos
nationalize	group=other_cos
naturalize	group=other_cos
neutralize	group=other_cos
normalize	group=other_cos
occlude	group=other_cos
open	group=other_cos
operate	group=other_cos
ossify	group=other_cos
overturn	group=other_cos
oxidize	group=other_cos
pale	group=other_cos
petrify	group=other_cos
plump	group=other_cos
polarize	group=other_cos
polymerize	group=other_cos
pop	group=other_cos
proliferate	group=other_cos
propagate	group=other_cos
pulverize	group=other_cos
purify	group=other_cos
purple	group=other_cos
putrefy	group=other_cos
quadruple	group=other_cos
quicken	group=other_cos
quiet	group=other_cos
quieten	group=other_cos
rarefy	group=other_cos
redden	group=other_cos
redouble	group=other_cos
rekindle	group=other_cos
reopen	group=other_cos
reproduce	group=other_cos
resuscitate	group=other_cos
reverse	group=other_cos
revive	group=other_cos
ripen	group=other_cos
roughen	group=other_cos
rupture	group=other_cos
saponify	group=other_cos
scorch	group=other_cos
sear	group=other_cos
sharpen	group=other_cos
short	group=other_cos
short-circuit	group=other_cos
shorten	group=other_cos
shrink	group=other_cos
shrivel	group=other_cos
shush	group=other_cos
shut	group=other_cos
sicken	group=other_cos
silicify	group=other_cos
silver	group=other_cos
sink	group=other_cos
slack	group=other_cos
slacken	group=other_cos
slim	group=other_cos
slow	group=other_cos
smarten	group=other_cos
smooth	group=other_cos
smoothen	group=other_cos
soak	group=other_cos
sober	group=other_cos
soften	group=other_cos
solidify	group=other_cos
sour	group=other_cos
souse	group=other_cos
sprout	group=other_cos
stabilize	group=other_cos
standardize	group=other_cos
steady	group=other_cos
steep	group=other_cos
steepen	group=other_cos
stiffen	group=other_cos
stratify	group=other_cos
strangulate	group=other_cos
strengthen	group=other_cos
submerge	group=other_cos
sunburn	group=other_cos
sweeten	group=other_cos
tame	group=other_cos
tan	group=other_cos
taper	group=other_cos
tauten	group=other_cos
tense	group=other_cos
thicken	group=other_cos
thin	group=other_cos
tighten	group=other_cos
tilt	group=other_cos
tire	group=other_cos
topple	group=other_cos
toughen	group=other_cos
tranquilize	group=other_cos
treble	group=other_cos
trip	group=other_cos
triple	group=other_cos
ulcerate	group=other_cos
unionize	group=other_cos
vaporize	group=other_cos
vary	group=other_cos
vibrate	group=other_cos
vitrify	group=other_cos
volatilize	group=other_cos
vulcanize	group=other_cos
wake	group=other_cos
waken	group=other_cos
warm	group=other_cos
weaken	group=other_cos
westernize	group=other_cos
wet	group=other_cos
whiten	group=other_cos
widen	group=other_cos
worsen	group=other_cos
yellow	group=other_cos
address	group=illustrate
adorn	group=illustrate
autograph	group=illustrate
bead	group=illustrate
brand	group=illustrate
date	group=illustrate
decorate	group=illustrate
embellish	group=illustrate
endorse	group=illustrate
gild	group=illustrate
ice	group=illustrate
illuminate	group=illustrate
illustrate	group=illustrate
initial	group=illustrate
label	group=illustrate
letter	group=illustrate
monogram	group=illustrate
ornament	group=illustrate
redecorate	group=illustrate
tag	group=illustrate
ask	group=inquire
enquire	group=inquire
inquire	group=inquire
consult	group=inquire
pry	group=inquire
behave	group=masquerade
count	group=masquerade
function	group=masquerade
masquerade	group=masquerade
officiate	group=masquerade
qualify	group=masquerade
rank	group=masquerade
act	group=masquerade
behave	group=masquerade
serve	group=masquerade
pose	group=masquerade
antique	group=berry
berry	group=berry
birdnest	group=berry
blackberry	group=berry
clam	group=berry
crab	group=berry
fish	group=berry
fowl	group=berry
grouse	group=berry
hay	group=berry
log	group=berry
mushroom	group=berry
nest	group=berry
nut	group=berry
oyster	group=berry
pearl	group=berry
prawn	group=berry
rabbit	group=berry
scollop	group=berry
seal	group=berry
shark	group=berry
shrimp	group=berry
snail	group=berry
snipe	group=berry
sponge	group=berry
whale	group=berry
whelk	group=berry
whore	group=berry
hawk	group=berry
bolt	group=gobble
gobble	group=gobble
wolf	group=gobble
gulp	group=gobble
guzzle	group=gobble
quaff	group=gobble
slug	group=gobble
swallow	group=gobble
swig	group=gobble
refrain	group=refrain
abstain	group=refrain
desist	group=refrain
forbear	group=refrain
adhere	group=cling
cleave	group=cling
cling	group=cling
bead	group=substance_emission
belch	group=substance_emission
bubble	group=substance_emission
dribble	group=substance_emission
drip	group=substance_emission
drool	group=substance_emission
emanate	group=substance_emission
exrete	group=substance_emission
exude	group=substance_emission
foam	group=substance_emission
gush	group=substance_emission
jet	group=substance_emission
leak	group=substance_emission
ooze	group=substance_emission
percolate	group=substance_emission
pour	group=substance_emission
puff	group=substance_emission
radiate	group=substance_emission
seep	group=substance_emission
shed	group=substance_emission
slop	group=substance_emission
spew	group=substance_emission
spill	group=substance_emission
spout	group=substance_emission
sprout	group=substance_emission
spurt	group=substance_emission
squirt	group=substance_emission
steam	group=substance_emission
stream	group=substance_emission
sweat	group=substance_emission
trickle	group=substance_emission
bleed	group=substance_emission
bereave	group=cheat
break	group=cheat
cleanse	group=cheat
cure	group=cheat
denude	group=cheat
deplete	group=cheat
depopulate	group=cheat
deprive	group=cheat
despoil	group=cheat
disabuse	group=cheat
disarm	group=cheat
disencumber	group=cheat
dispossess	group=cheat
divest	group=cheat
purge	group=cheat
purify	group=cheat
ransack	group=cheat
relieve	group=cheat
render	group=cheat
rid	group=cheat
rifle	group=cheat
strip	group=cheat
unburden	group=cheat
wean	group=cheat
whitewash	group=cheat
bilk	group=cheat
bleed	group=cheat
cheat	group=cheat
defraud	group=cheat
rob	group=cheat
sap	group=cheat
gull	group=cheat
fleece	group=cheat
cull	group=cheat
burgle	group=cheat
con	group=cheat
cozen	group=cheat
drain	group=cheat
ease	group=cheat
milk	group=cheat
mulct	group=cheat
plunder	group=cheat
swindle	group=cheat
intermarry	group=amalgamate
couple	group=amalgamate
incorporate	group=amalgamate
integrate	group=amalgamate
match	group=amalgamate
overlap	group=amalgamate
amalgamate	group=amalgamate
coalesce	group=amalgamate
consolidate	group=amalgamate
intermingle	group=amalgamate
conjoin	group=amalgamate
entangle	group=amalgamate
muddle	group=amalgamate
pair	group=amalgamate
team	group=amalgamate
affiliate	group=amalgamate
associate	group=amalgamate
compare	group=amalgamate
confederate	group=amalgamate
confuse	group=amalgamate
incorporate	group=amalgamate
integrate	group=amalgamate
total	group=amalgamate
identity	group=amalgamate
alternate	group=amalgamate
crisscross	group=amalgamate
entwine	group=amalgamate
interchange	group=amalgamate
interconnect	group=amalgamate
interlace	group=amalgamate
interlink	group=amalgamate
interlock	group=amalgamate
intersperse	group=amalgamate
intertwine	group=amalgamate
interweave	group=amalgamate
mate	group=amalgamate
unite	group=amalgamate
coalesce	group=amalgamate
coincide	group=amalgamate
conflate	group=amalgamate
consolidate	group=amalgamate
contrast	group=amalgamate
correlate	group=amalgamate
harmonize	group=amalgamate
intermingle	group=amalgamate
interrelate	group=amalgamate
repackage	group=amalgamate
rhyme	group=amalgamate
unify	group=amalgamate
oppose	group=amalgamate
introduce	group=amalgamate
figure	group=amalgamate
marry	group=amalgamate
remarry	group=amalgamate
wed	group=amalgamate
engage	group=amalgamate
bet	group=risk
gamble	group=risk
punt	group=risk
venture	group=risk
wager	group=risk
chance	group=risk
risk	group=risk
hazard	group=risk
abash	group=amuse
affect	group=amuse
afflict	group=amuse
affront	group=amuse
aggravate	group=amuse
aggrieve	group=amuse
agitate	group=amuse
agonize	group=amuse
alarm	group=amuse
alienate	group=amuse
amaze	group=amuse
amuse	group=amuse
anger	group=amuse
annoy	group=amuse
antagonize	group=amuse
appall	group=amuse
appease	group=amuse
arouse	group=amuse
assuage	group=amuse
astonish	group=amuse
astound	group=amuse
awe	group=amuse
baffle	group=amuse
befuddle	group=amuse
beguile	group=amuse
bewilder	group=amuse
bewitch	group=amuse
boggle	group=amuse
bore	group=amuse
bother	group=amuse
browbeat	group=amuse
bug	group=amuse
calm	group=amuse
captivate	group=amuse
chagrin	group=amuse
charm	group=amuse
cheer	group=amuse
chill	group=amuse
cloy	group=amuse
comfort	group=amuse
concern	group=amuse
confound	group=amuse
confuse	group=amuse
console	group=amuse
content	group=amuse
convince	group=amuse
cow	group=amuse
crush	group=amuse
cut	group=amuse
daunt	group=amuse
daze	group=amuse
dazzle	group=amuse
deject	group=amuse
delight	group=amuse
demolish	group=amuse
demoralize	group=amuse
depress	group=amuse
devastate	group=amuse
disappoint	group=amuse
disarm	group=amuse
discombobulate	group=amuse
discomfit	group=amuse
disconcert	group=amuse
discompose	group=amuse
discourage	group=amuse
disgrace	group=amuse
disgruntle	group=amuse
disgust	group=amuse
dishearten	group=amuse
dishonour	group=amuse
disillusion	group=amuse
dismay	group=amuse
dispirit	group=amuse
displease	group=amuse
disquiet	group=amuse
dissatisfy	group=amuse
distract	group=amuse
distress	group=amuse
disturb	group=amuse
divert	group=amuse
dumbfound	group=amuse
elate	group=amuse
electrify	group=amuse
embarrass	group=amuse
embolden	group=amuse
enchant	group=amuse
encourage	group=amuse
enervate	group=amuse
enflame	group=amuse
engage	group=amuse
engross	group=amuse
enlighten	group=amuse
enliven	group=amuse
enrage	group=amuse
enrapture	group=amuse
entertain	group=amuse
enthrall	group=amuse
enthuse	group=amuse
entice	group=amuse
entrance	group=amuse
exasperate	group=amuse
excite	group=amuse
exhaust	group=amuse
exhilarate	group=amuse
fascinate	group=amuse
fatigue	group=amuse
faze	group=amuse
flabbergast	group=amuse
flatter	group=amuse
floor	group=amuse
flummox	group=amuse
fluster	group=amuse
fox	group=amuse
frighten	group=amuse
frustrate	group=amuse
fuddle	group=amuse
gall	group=amuse
galvanize	group=amuse
gladden	group=amuse
gratify	group=amuse
grieve	group=amuse
harass	group=amuse
harm	group=amuse
haunt	group=amuse
hearten	group=amuse
horrify	group=amuse
humble	group=amuse
humiliate	group=amuse
hurt	group=amuse
hypnotize	group=amuse
impair	group=amuse
impress	group=amuse
incense	group=amuse
inflame	group=amuse
infuriate	group=amuse
inspire	group=amuse
insult	group=amuse
interest	group=amuse
intimidate	group=amuse
intoxicate	group=amuse
intrigue	group=amuse
invigorate	group=amuse
irk	group=amuse
irritate	group=amuse
jade	group=amuse
jar	group=amuse
jollify	group=amuse
jolt	group=amuse
lull	group=amuse
madden	group=amuse
menace	group=amuse
mesmerize	group=amuse
miff	group=amuse
misguide	group=amuse
molest	group=amuse
mollify	group=amuse
mortify	group=amuse
move	group=amuse
muddle	group=amuse
mystify	group=amuse
nauseate	group=amuse
nettle	group=amuse
nonplus	group=amuse
numb	group=amuse
obsess	group=amuse
occupy	group=amuse
offend	group=amuse
outrage	group=amuse
overawe	group=amuse
overwhelm	group=amuse
pacify	group=amuse
pain	group=amuse
peeve	group=amuse
perplex	group=amuse
perturb	group=amuse
pester	group=amuse
pique	group=amuse
placate	group=amuse
plague	group=amuse
please	group=amuse
preoccupy	group=amuse
provoke	group=amuse
puzzle	group=amuse
quench	group=amuse
rag	group=amuse
rankle	group=amuse
ravish	group=amuse
reassure	group=amuse
recharge	group=amuse
refresh	group=amuse
rejuvenate	group=amuse
relax	group=amuse
relieve	group=amuse
repel	group=amuse
repulse	group=amuse
revitalize	group=amuse
revolt	group=amuse
rile	group=amuse
ruffle	group=amuse
sadden	group=amuse
satiate	group=amuse
satisfy	group=amuse
scandalize	group=amuse
scare	group=amuse
shake	group=amuse
shame	group=amuse
shock	group=amuse
sicken	group=amuse
sober	group=amuse
solace	group=amuse
soothe	group=amuse
spellbind	group=amuse
spook	group=amuse
stagger	group=amuse
startle	group=amuse
stimulate	group=amuse
sting	group=amuse
stir	group=amuse
strike	group=amuse
stump	group=amuse
stun	group=amuse
stupefy	group=amuse
surprise	group=amuse
tantalize	group=amuse
taunt	group=amuse
tease	group=amuse
tempt	group=amuse
terrify	group=amuse
terrorize	group=amuse
threaten	group=amuse
thrill	group=amuse
throw	group=amuse
tickle	group=amuse
tire	group=amuse
titillate	group=amuse
torment	group=amuse
torture	group=amuse
touch	group=amuse
transfix	group=amuse
transport	group=amuse
trouble	group=amuse
try	group=amuse
unnerve	group=amuse
unsettle	group=amuse
uplift	group=amuse
upset	group=amuse
vex	group=amuse
weary	group=amuse
worry	group=amuse
wound	group=amuse
wow	group=amuse
roil	group=amuse
smite	group=amuse
dally	group=linger
dawdle	group=linger
dither	group=linger
equivocate	group=linger
hesitate	group=linger
linger	group=linger
loaf	group=linger
loiter	group=linger
pause	group=linger
potter	group=linger
procrastinate	group=linger
putter	group=linger
tarry	group=linger
delay	group=linger
scruple	group=linger
stall	group=linger
bellyache	group=complain
bitch	group=complain
boast	group=complain
brag	group=complain
caterwaul	group=complain
complain	group=complain
crab	group=complain
gripe	group=complain
grouch	group=complain
grouse	group=complain
grumble	group=complain
kvetch	group=complain
moan	group=complain
object	group=complain
whine	group=complain
adorn	group=fill
anoint	group=fill
bandage	group=fill
bathe	group=fill
bestrew	group=fill
bind	group=fill
blacktop	group=fill
blanket	group=fill
block	group=fill
blockade	group=fill
blot	group=fill
bombard	group=fill
carpet	group=fill
choke	group=fill
cloak	group=fill
clog	group=fill
clutter	group=fill
coat	group=fill
contaminate	group=fill
cover	group=fill
dam	group=fill
dapple	group=fill
deck	group=fill
decorate	group=fill
deluge	group=fill
dirty	group=fill
disguise	group=fill
dope	group=fill
douse	group=fill
dot	group=fill
drench	group=fill
edge	group=fill
embellish	group=fill
emblazon	group=fill
encircle	group=fill
encrust	group=fill
endow	group=fill
enrich	group=fill
entangle	group=fill
face	group=fill
festoon	group=fill
fill	group=fill
fleck	group=fill
flood	group=fill
frame	group=fill
garland	group=fill
garnish	group=fill
grace	group=fill
gild	group=fill
gum up	group=fill
honeycomb	group=fill
imbue	group=fill
impregnate	group=fill
infect	group=fill
infest	group=fill
inlay	group=fill
interlace	group=fill
interlard	group=fill
interleave	group=fill
intersperse	group=fill
interweave	group=fill
inundate	group=fill
lard	group=fill
lash	group=fill
line	group=fill
litter	group=fill
mask	group=fill
marinate	group=fill
mottle	group=fill
ornament	group=fill
pad	group=fill
panel	group=fill
pave	group=fill
plate	group=fill
plug	group=fill
prefill	group=fill
redecorate	group=fill
replenish	group=fill
repopulate	group=fill
resupply	group=fill
riddle	group=fill
ring	group=fill
ripple	group=fill
robe	group=fill
saturate	group=fill
sauce	group=fill
season	group=fill
shroud	group=fill
smother	group=fill
smut	group=fill
soak	group=fill
soil	group=fill
speckle	group=fill
splotch	group=fill
spot	group=fill
staff	group=fill
stipple	group=fill
stop up	group=fill
stud	group=fill
suffuse	group=fill
sully	group=fill
surround	group=fill
swaddle	group=fill
swathe	group=fill
taint	group=fill
tile	group=fill
tinge	group=fill
tool	group=fill
trim	group=fill
veil	group=fill
vein	group=fill
inject	group=fill
pollute	group=fill
stain	group=fill
sum	group=multiply
add	group=multiply
tally	group=multiply
count	group=multiply
multiply	group=multiply
divide	group=multiply
deduct	group=multiply
factor out	group=multiply
interpolate	group=multiply
extrapolate	group=multiply
subtract	group=multiply
average	group=multiply
try	group=try
attempt	group=try
intend	group=try
alert	group=advise
assure	group=advise
brief	group=advise
educate	group=advise
encourage	group=advise
inform	group=advise
notify	group=advise
admonish	group=advise
advise	group=advise
caution	group=advise
counsel	group=advise
instruct	group=advise
warn	group=advise
carry	group=cost
cost	group=cost
last	group=cost
net	group=cost
take	group=cost
loop	group=coil
roll	group=coil
rotate	group=coil
spin	group=coil
swirl	group=coil
twine	group=coil
whirl	group=coil
wind	group=coil
curl	group=coil
coil	group=coil
hook	group=coil
swing	group=coil
twirl	group=coil
twist	group=coil
necessitate	group=require
need	group=require
require	group=require
take	group=require
involve	group=require
demand	group=require
annihilate	group=destroy
blight	group=destroy
blitz	group=destroy
damage	group=destroy
decimate	group=destroy
demolish	group=destroy
desecrate	group=destroy
destroy	group=destroy
devastate	group=destroy
disfigure	group=destroy
efface	group=destroy
exterminate	group=destroy
extirpate	group=destroy
level	group=destroy
louse up	group=destroy
maim	group=destroy
mutilate	group=destroy
obliterate	group=destroy
rack	group=destroy
ravage	group=destroy
raze	group=destroy
ruin	group=destroy
shipwreck	group=destroy
smoke	group=destroy
undo	group=destroy
unmake	group=destroy
vaporize	group=destroy
waste	group=destroy
wrack	group=destroy
wreck	group=destroy
shatter	group=destroy
view	group=consider
acknowledge	group=consider
deem	group=consider
esteem	group=consider
rate	group=consider
reckon	group=consider
report	group=consider
know	group=consider
recognize	group=consider
see	group=consider
consider	group=consider
remember	group=consider
imagine	group=consider
suspect	group=consider
think	group=consider
feel	group=consider
suppose	group=consider
posit	group=consider
believe	group=consider
canvass	group=investigate
explore	group=investigate
examine	group=investigate
frisk	group=investigate
inspect	group=investigate
investigate	group=investigate
monitor	group=investigate
observe	group=investigate
picket	group=investigate
quiz	group=investigate
raid	group=investigate
ransack	group=investigate
riffle	group=investigate
scan	group=investigate
scrutinize	group=investigate
surveil	group=investigate
survey	group=investigate
tap	group=investigate
test	group=investigate
tour	group=investigate
admonish	group=urge
ask	group=urge
badger	group=urge
beg	group=urge
egg on	group=urge
entreat	group=urge
exhort	group=urge
extort	group=urge
lobby	group=urge
urge	group=urge
implore	group=urge
press	group=urge
babble	group=manner_speaking
bark	group=manner_speaking
bawl	group=manner_speaking
bellow	group=manner_speaking
bleat	group=manner_speaking
blubber	group=manner_speaking
boom	group=manner_speaking
bray	group=manner_speaking
burble	group=manner_speaking
bluster	group=manner_speaking
cackle	group=manner_speaking
call	group=manner_speaking
carol	group=manner_speaking
chant	group=manner_speaking
chatter	group=manner_speaking
chirp	group=manner_speaking
chortle	group=manner_speaking
chuckle	group=manner_speaking
cluck	group=manner_speaking
coo	group=manner_speaking
croak	group=manner_speaking
croon	group=manner_speaking
crow	group=manner_speaking
cry	group=manner_speaking
drawl	group=manner_speaking
drone	group=manner_speaking
gabble	group=manner_speaking
gasp	group=manner_speaking
gibber	group=manner_speaking
groan	group=manner_speaking
growl	group=manner_speaking
grumble	group=manner_speaking
grunt	group=manner_speaking
hiss	group=manner_speaking
holler	group=manner_speaking
hoot	group=manner_speaking
howl	group=manner_speaking
jabber	group=manner_speaking
keen	group=manner_speaking
lilt	group=manner_speaking
lisp	group=manner_speaking
mewl	group=manner_speaking
moan	group=manner_speaking
mumble	group=manner_speaking
murmur	group=manner_speaking
mutter	group=manner_speaking
nasal	group=manner_speaking
natter	group=manner_speaking
pant	group=manner_speaking
prattle	group=manner_speaking
purr	group=manner_speaking
quaver	group=manner_speaking
rage	group=manner_speaking
rant	group=manner_speaking
rasp	group=manner_speaking
roar	group=manner_speaking
rumble	group=manner_speaking
scream	group=manner_speaking
screech	group=manner_speaking
shout	group=manner_speaking
shriek	group=manner_speaking
sibilate	group=manner_speaking
simper	group=manner_speaking
sigh	group=manner_speaking
sing	group=manner_speaking
smatter	group=manner_speaking
smile	group=manner_speaking
snap	group=manner_speaking
snarl	group=manner_speaking
snivel	group=manner_speaking
snuffle	group=manner_speaking
splutter	group=manner_speaking
squall	group=manner_speaking
squawk	group=manner_speaking
squeak	group=manner_speaking
squeal	group=manner_speaking
stammer	group=manner_speaking
stemmer	group=manner_speaking
stutter	group=manner_speaking
thunder	group=manner_speaking
tisk	group=manner_speaking
trill	group=manner_speaking
trumpet	group=manner_speaking
twang	group=manner_speaking
twitter	group=manner_speaking
vociferate	group=manner_speaking
wail	group=manner_speaking
warble	group=manner_speaking
wheeze	group=manner_speaking
whimper	group=manner_speaking
whine	group=manner_speaking
whisper	group=manner_speaking
whistle	group=manner_speaking
witter	group=manner_speaking
whoop	group=manner_speaking
yammer	group=manner_speaking
yap	group=manner_speaking
yell	group=manner_speaking
yelp	group=manner_speaking
yodel	group=manner_speaking
blare	group=manner_speaking
gurgle	group=manner_speaking
hum	group=manner_speaking
banquet	group=dine
breakfast	group=dine
brunch	group=dine
dine	group=dine
feast	group=dine
graze	group=dine
junket	group=dine
lunch	group=dine
luncheon	group=dine
nosh	group=dine
picnic	group=dine
snack	group=dine
sup	group=dine
bombard	group=pelt
buffet	group=pelt
pelt	group=pelt
pepperspray	group=pelt
shell	group=pelt
shower	group=pelt
stone	group=pelt
confess	group=confess
admit	group=confess
acknowledge	group=confess
fess up	group=confess
proclaim	group=confess
reveal	group=confess
bullock	group=force
bamboozle	group=force
coax	group=force
coerce	group=force
commission	group=force
compel	group=force
convince	group=force
cozen	group=force
dare	group=force
draw	group=force
encourage	group=force
entice	group=force
force	group=force
goad	group=force
impel	group=force
incite	group=force
induce	group=force
inveigle	group=force
jolt	group=force
lead	group=force
mislead	group=force
motivate	group=force
obligate	group=force
oblige	group=force
palaver	group=force
persuade	group=force
press	group=force
pressure	group=force
prod	group=force
prompt	group=force
push	group=force
rush	group=force
rouse	group=force
fox	group=force
soothe	group=force
spur	group=force
steamroller	group=force
suborn	group=force
sway	group=force
sweet-talk	group=force
tempt	group=force
bullshit	group=force
sandbag	group=force
railroad	group=force
dragoon	group=force
hound	group=force
allure	group=force
annoy	group=force
arm-twist	group=force
bait	group=force
bluff	group=force
blackmail	group=force
bribe	group=force
bully	group=force
cajole	group=force
cheat	group=force
commander	group=force
con	group=force
deceive	group=force
delude	group=force
draw	group=force
dupe	group=force
ensnare	group=force
entrap	group=force
flatter	group=force
fool	group=force
frighten	group=force
guide	group=force
harass	group=force
harry	group=force
hijack	group=force
hoodwink	group=force
hustle	group=force
influence	group=force
seduce	group=force
lure	group=force
manipulate	group=force
organize	group=force
panic	group=force
set	group=force
shame	group=force
shock	group=force
stimulate	group=force
talk	group=force
tease	group=force
terrify	group=force
trap	group=force
trick	group=force
wheedle	group=force
adapt	group=adjust
accommodate	group=adjust
conform	group=adjust
adjust	group=adjust
gear	group=adjust
fit	group=adjust
readjust	group=adjust
readapt	group=adjust
assimilate	group=adjust
bathe	group=dress
change	group=dress
clothe	group=dress
disrobe	group=dress
dress	group=dress
exercise	group=dress
frock	group=dress
lave	group=dress
moisturize	group=dress
preen	group=dress
primp	group=dress
shave	group=dress
shower	group=dress
strip	group=dress
sunbathe	group=dress
tan	group=dress
unclothe	group=dress
undress	group=dress
wash	group=dress
affix	group=tape
anchor	group=tape
band	group=tape
belt	group=tape
bond	group=tape
bolt	group=tape
bracket	group=tape
buckle	group=tape
button	group=tape
cable	group=tape
cement	group=tape
chain	group=tape
cinch	group=tape
connect	group=tape
epoxy	group=tape
fasten	group=tape
fetter	group=tape
glue	group=tape
gum	group=tape
handcuff	group=tape
harness	group=tape
hinge	group=tape
hitch	group=tape
hook	group=tape
knot	group=tape
lace	group=tape
lash	group=tape
lasso	group=tape
latch	group=tape
leash	group=tape
link	group=tape
lock	group=tape
loop	group=tape
manacle	group=tape
moor	group=tape
muzzle	group=tape
nail	group=tape
padlock	group=tape
paste	group=tape
peg	group=tape
pin	group=tape
plaster	group=tape
rivet	group=tape
rope	group=tape
screw	group=tape
seal	group=tape
shackle	group=tape
skewer	group=tape
solder	group=tape
staple	group=tape
stitch	group=tape
strap	group=tape
string	group=tape
suture	group=tape
tack	group=tape
tape	group=tape
tether	group=tape
thread	group=tape
thumbtack	group=tape
tie	group=tape
trammel	group=tape
truss	group=tape
weld	group=tape
wire	group=tape
yoke	group=tape
zip	group=tape
clamp	group=tape
clip	group=tape
clasp	group=tape
gum	group=tape
paste	group=tape
reeve	group=tape
bake	group=cooking
barbecue	group=cooking
barbeque	group=cooking
blanch	group=cooking
boil	group=cooking
braise	group=cooking
broil	group=cooking
brown	group=cooking
char	group=cooking
charbroil	group=cooking
charcoal-broil	group=cooking
coddle	group=cooking
cook	group=cooking
crisp	group=cooking
deep-fry	group=cooking
french-fry	group=cooking
fry	group=cooking
grill	group=cooking
hardboil	group=cooking
heat	group=cooking
microwave	group=cooking
oven-fry	group=cooking
oven-poach	group=cooking
overbake	group=cooking
overcook	group=cooking
overheat	group=cooking
pan-broil	group=cooking
pan-fry	group=cooking
parboil	group=cooking
parch	group=cooking
percolate	group=cooking
perk	group=cooking
pickle	group=cooking
plank	group=cooking
poach	group=cooking
pot-roast	group=cooking
reheat	group=cooking
rissole	group=cooking
roast	group=cooking
saute	group=cooking
scald	group=cooking
scallop	group=cooking
sear	group=cooking
shirr	group=cooking
simmer	group=cooking
softboil	group=cooking
steam	group=cooking
steam-bake	group=cooking
steep	group=cooking
stew	group=cooking
stir-fry	group=cooking
toast	group=cooking
warm up	group=cooking
smell	group=see
taste	group=see
detect	group=see
discern	group=see
feel	group=see
sense	group=see
perceive	group=see
notice	group=see
see	group=see
hear	group=see
boogie	group=waltz
bop	group=waltz
cancan	group=waltz
clog	group=waltz
conga	group=waltz
dance	group=waltz
foxtrot	group=waltz
jig	group=waltz
jitterbug	group=waltz
jive	group=waltz
pirouette	group=waltz
polka	group=waltz
quickstep	group=waltz
rumba	group=waltz
samba	group=waltz
shuffle	group=waltz
squaredance	group=waltz
tango	group=waltz
tapdance	group=waltz
waltz	group=waltz
disassociate	group=separate
sever	group=separate
uncoil	group=separate
decouple	group=separate
differentiate	group=separate
disentangle	group=separate
dissimilate	group=separate
divide	group=separate
divorce	group=separate
segregate	group=separate
disconnect	group=separate
dissociate	group=separate
part	group=separate
separate	group=separate
behold	group=sight
descry	group=sight
discover	group=sight
espy	group=sight
examine	group=sight
experience	group=sight
eye	group=sight
glimpse	group=sight
inspect	group=sight
investigate	group=sight
make out	group=sight
note	group=sight
observe	group=sight
overhear	group=sight
perceive	group=sight
peruse	group=sight
pick	group=sight
recognize	group=sight
regard	group=sight
savor	group=sight
scan	group=sight
scent	group=sight
scent out	group=sight
scrutinize	group=sight
sight	group=sight
spot	group=sight
spy	group=sight
study	group=sight
surveil	group=sight
survey	group=sight
view	group=sight
watch	group=sight
witness	group=sight
sniff	group=sight
terminate	group=stop
halt	group=stop
repeat	group=stop
cease	group=stop
conclude	group=stop
end	group=stop
finish	group=stop
stop	group=stop
admire	group=admire
adore	group=admire
appreciate	group=admire
applaud	group=admire
bear	group=admire
bewail	group=admire
cherish	group=admire
deify	group=admire
detest	group=admire
disbelieve	group=admire
esteem	group=admire
exalt	group=admire
fancy	group=admire
favor	group=admire
grudge	group=admire
idolize	group=admire
miss	group=admire
mistrust	group=admire
prefer	group=admire
affirm	group=admire
reaffirm	group=admire
prize	group=admire
respect	group=admire
relish	group=admire
revere	group=admire
savor	group=admire
stand	group=admire
support	group=admire
tolerate	group=admire
treasure	group=admire
trust	group=admire
value	group=admire
venerate	group=admire
worship	group=admire
abhor	group=admire
deplore	group=admire
distrust	group=admire
dread	group=admire
envy	group=admire
execrate	group=admire
lament	group=admire
loathe	group=admire
mourn	group=admire
pity	group=admire
resent	group=admire
rue	group=admire
believe	group=admire
suffer	group=admire
despise	group=admire
disdain	group=admire
dislike	group=admire
regret	group=admire
like	group=admire
love	group=admire
enjoy	group=admire
fear	group=admire
hate	group=admire
cram	group=learn
read	group=learn
relearn	group=learn
study	group=learn
learn	group=learn
glean	group=learn
memorize	group=learn
assimilate	group=learn
learn	group=learn
read	group=learn
exist	group=gorge
feed	group=gorge
flourish	group=gorge
gorge	group=gorge
live	group=gorge
prosper	group=gorge
subsist	group=gorge
survive	group=gorge
thrive	group=gorge
annul	group=void
quash	group=void
void	group=void
avoid	group=void
invalidate	group=void
nullify	group=void
blanch	group=change_bodily_state
blench	group=change_bodily_state
faint	group=change_bodily_state
pale	group=change_bodily_state
sicken	group=change_bodily_state
black out	group=change_bodily_state
swoon	group=change_bodily_state
doze off	group=change_bodily_state
drift off	group=change_bodily_state
konk out	group=change_bodily_state
nod off	group=change_bodily_state
pass out	group=change_bodily_state
zonk out	group=change_bodily_state
mine	group=mine
quarry	group=mine
focus	group=focus
focalize	group=focus
center	group=focus
concentrate	group=focus
converge	group=focus
brood	group=focus
marinate	group=focus
fixate	group=focus
abduct	group=steal
annex	group=steal
cabbage	group=steal
carjack	group=steal
commandeer	group=steal
confiscate	group=steal
emancipate	group=steal
embezzle	group=steal
extort	group=steal
filch	group=steal
highjack	group=steal
kidnap	group=steal
knock off	group=steal
liberate	group=steal
lift	group=steal
misappropriate	group=steal
nobble	group=steal
pickpocket	group=steal
pinch	group=steal
plagiarize	group=steal
purloin	group=steal
recapture	group=steal
reclaim	group=steal
recoup	group=steal
redeem	group=steal
repossess	group=steal
rescue	group=steal
rustle	group=steal
seize	group=steal
snatch away	group=steal
sequester	group=steal
take	group=steal
thieve	group=steal
weasel out	group=steal
wrest	group=steal
cadge	group=steal
capture	group=steal
cop	group=steal
flog	group=steal
grab	group=steal
hook	group=steal
nab	group=steal
nick	group=steal
pilfer	group=steal
pirate	group=steal
salvage	group=steal
shoplift	group=steal
smuggle	group=steal
snatch	group=steal
sneak	group=steal
steal	group=steal
swipe	group=steal
wangle	group=steal
accompany	group=accompany
conduct	group=accompany
escort	group=accompany
guide	group=accompany
lead	group=accompany
misdirect	group=accompany
shepherd	group=accompany
steer	group=accompany
vacate	group=resign
resign	group=resign
renounce	group=resign
leave	group=resign
quit	group=resign
abdicate	group=resign
retire	group=resign
withdraw	group=resign
depart	group=resign
barter	group=exchange
forgo	group=exchange
jilt	group=exchange
replace	group=exchange
change	group=exchange
exchange	group=exchange
switch	group=exchange
trade	group=exchange
substitute	group=exchange
swap	group=exchange
billow	group=entity_specific_modes_being
bloom	group=entity_specific_modes_being
blossom	group=entity_specific_modes_being
bristle	group=entity_specific_modes_being
bulge	group=entity_specific_modes_being
burn	group=entity_specific_modes_being
effervesce	group=entity_specific_modes_being
fester	group=entity_specific_modes_being
fizz	group=entity_specific_modes_being
flow	group=entity_specific_modes_being
flower	group=entity_specific_modes_being
flux	group=entity_specific_modes_being
foam	group=entity_specific_modes_being
froth	group=entity_specific_modes_being
moil	group=entity_specific_modes_being
propagate	group=entity_specific_modes_being
rage	group=entity_specific_modes_being
ripple	group=entity_specific_modes_being
roil	group=entity_specific_modes_being
seethe	group=entity_specific_modes_being
smolder	group=entity_specific_modes_being
sprout	group=entity_specific_modes_being
assume	group=adopt
adopt	group=adopt
take over	group=adopt
take on	group=adopt
dedicate	group=dedicate
devote	group=dedicate
commit	group=dedicate
bustle	group=swarm
crawl	group=swarm
creep	group=swarm
hop	group=swarm
run	group=swarm
swarm	group=swarm
swim	group=swarm
teem	group=swarm
pullulate	group=swarm
throng	group=swarm
abound	group=swarm
use	group=consume
consume	group=consume
pass	group=consume
reuse	group=consume
spend	group=consume
squander	group=consume
waste	group=consume
deaccent	group=debone
debark	group=debone
debone	group=debone
debowel	group=debone
debug	group=debone
debur	group=debone
declaw	group=debone
decontaminate	group=debone
defang	group=debone
defat	group=debone
defeather	group=debone
deflea	group=debone
deflesh	group=debone
deflower	group=debone
defoam	group=debone
defog	group=debone
deforest	group=debone
defrost	group=debone
defuzz	group=debone
degas	group=debone
degerm	group=debone
deglaze	group=debone
degrease	group=debone
degrit	group=debone
degum	group=debone
degut	group=debone
dehair	group=debone
dehead	group=debone
dehorn	group=debone
dehull	group=debone
dehusk	group=debone
deice	group=debone
deink	group=debone
delint	group=debone
delouse	group=debone
deluster	group=debone
demast	group=debone
derat	group=debone
derib	group=debone
derind	group=debone
desalt	group=debone
descale	group=debone
desex	group=debone
desprout	group=debone
destarch	group=debone
destress	group=debone
detassel	group=debone
detusk	group=debone
devein	group=debone
dewater	group=debone
dewax	group=debone
deworm	group=debone
disembowel	group=debone
eviscerate	group=debone
charge	group=equip
invest	group=equip
ply	group=equip
arm	group=equip
equip	group=equip
outfit	group=equip
rearm	group=equip
redress	group=equip
regale	group=equip
reward	group=equip
saddle	group=equip
treat	group=equip
armor	group=equip
encumber	group=equip
fortify	group=equip
overburden	group=equip
weight	group=equip
burden	group=equip
compensate	group=equip
appoint	group=appoint
coronate	group=appoint
crown	group=appoint
designate	group=appoint
elect	group=appoint
install	group=appoint
proclaim	group=appoint
mark	group=appoint
ordain	group=appoint
adopt	group=appoint
upgrade	group=appoint
reelect	group=appoint
want	group=appoint
name	group=appoint
nominate	group=appoint
speak	group=talk
talk	group=talk
eat	group=eat
drink	group=eat
arch	group=crane
bare	group=crane
bat	group=crane
beat	group=crane
blow	group=crane
clench	group=crane
click	group=crane
close	group=crane
cock	group=crane
crane	group=crane
crook	group=crane
cross	group=crane
drum	group=crane
flap	group=crane
flash	group=crane
flex	group=crane
flick	group=crane
flutter	group=crane
fold	group=crane
gnash	group=crane
grind	group=crane
hang	group=crane
hunch	group=crane
kick	group=crane
knit	group=crane
open	group=crane
pucker	group=crane
purse	group=crane
raise	group=crane
roll	group=crane
rub	group=crane
shake	group=crane
show	group=crane
shuffle	group=crane
smack	group=crane
snap	group=crane
stamp	group=crane
stretch	group=crane
toss	group=crane
turn	group=crane
twiddle	group=crane
twitch	group=crane
wag	group=crane
waggle	group=crane
wiggle	group=crane
wring	group=crane
wrinkle	group=crane
court	group=marry
cuddle	group=marry
date	group=marry
divorce	group=marry
embrace	group=marry
hug	group=marry
kiss	group=marry
marry	group=marry
nuzzle	group=marry
pet	group=marry
issue	group=fulfilling
leave	group=fulfilling
present	group=fulfilling
trust	group=fulfilling
credit	group=fulfilling
entrust	group=fulfilling
furnish	group=fulfilling
resupply	group=fulfilling
serve	group=fulfilling
supply	group=fulfilling
provide	group=fulfilling
consult	group=meet
deliberate	group=meet
meet	group=meet
play	group=meet
remonstrate	group=meet
reunite	group=meet
visit	group=meet
battle	group=meet
box	group=meet
debate	group=meet
fight	group=meet
bite	group=swat
chop	group=swat
claw	group=swat
kick	group=swat
paw	group=swat
peck	group=swat
punch	group=swat
scratch	group=swat
slice	group=swat
slug	group=swat
stab	group=swat
swat	group=swat
swipe	group=swat
cross-examine	group=interrogate
question	group=interrogate
interview	group=interrogate
interrogate	group=interrogate
overstate	group=overstate
overdraw	group=overstate
hyperbolize	group=overstate
magnify	group=overstate
amplify	group=overstate
overemphasize	group=overstate
overrate	group=overstate
overstress	group=overstate
tout	group=overstate
glorify	group=overstate
covet	group=want
crave	group=want
desire	group=want
fancy	group=want
enjoy	group=want
want	group=want
need	group=want
like	group=want
prefer	group=want
desire	group=want
advance	group=escape
approach	group=escape
come	group=escape
decamp	group=escape
fall	group=escape
file	group=escape
go	group=escape
plunge	group=escape
recede	group=escape
return	group=escape
rise	group=escape
tumble	group=escape
arrive	group=escape
set off	group=escape
set out	group=escape
bolt	group=escape
emerge	group=escape
emigrate	group=escape
retreat	group=escape
skedaddle	group=escape
vamoose	group=escape
withdraw	group=escape
depart	group=escape
disembark	group=escape
escape	group=escape
exit	group=escape
flee	group=escape
leave	group=escape
vacate	group=escape
enter	group=escape
approach	group=escape
ascend	group=escape
climb	group=escape
cross	group=escape
descend	group=escape
acquaint	group=tell
inform	group=tell
apprise	group=tell
notify	group=tell
advise	group=tell
update	group=tell
remind	group=tell
tell	group=tell
cast	group=throw
discard	group=throw
bash	group=throw
bat	group=throw
bunt	group=throw
chuck	group=throw
fire	group=throw
flick	group=throw
fling	group=throw
flip	group=throw
hit	group=throw
hurl	group=throw
knock	group=throw
lob	group=throw
loft	group=throw
nudge	group=throw
pass	group=throw
pitch	group=throw
punt	group=throw
shoot	group=throw
shove	group=throw
slam	group=throw
slap	group=throw
sling	group=throw
smash	group=throw
tap	group=throw
boot	group=throw
catapult	group=throw
kick	group=throw
launch	group=throw
throw	group=throw
tip	group=throw
toss	group=throw
beget	group=engender
bring about	group=engender
cause	group=engender
create	group=engender
engender	group=engender
generate	group=engender
incite	group=engender
inspire	group=engender
instigate	group=engender
kindle	group=engender
produce	group=engender
provoke	group=engender
set off	group=engender
shape	group=engender
sire	group=engender
spark	group=engender
spawn	group=engender
actuate	group=engender
arouse	group=engender
call forth	group=engender
elicit	group=engender
prompt	group=engender
stimulate	group=engender
stir up	group=engender
reek	group=smell_emission
smell	group=smell_emission
stink	group=smell_emission
matter	group=matter
count	group=matter
attain	group=get
book	group=get
buy	group=get
call	group=get
catch	group=get
charter	group=get
choose	group=get
conserve	group=get
find	group=get
gather	group=get
hire	group=get
lease	group=get
order	group=get
phone	group=get
pick	group=get
pluck	group=get
procure	group=get
pull	group=get
reach	group=get
rent	group=get
reserve	group=get
shoot	group=get
slaughter	group=get
vote	group=get
win	group=get
earn	group=get
fetch	group=get
cash	group=get
gain	group=get
get	group=get
save	group=get
score	group=get
secure	group=get
steal	group=get
coincide	group=correlate
correlate	group=correlate
alternate	group=correlate
flip-flop	group=correlate
co-occur	group=correlate
maintain	group=declare
prove	group=declare
declare	group=declare
find	group=declare
judge	group=declare
profess	group=declare
proclaim	group=declare
settle	group=settle
concur	group=settle
contract	group=settle
harmonize	group=settle
bargain	group=settle
consent	group=settle
cohere	group=settle
jibe	group=settle
square	group=settle
resolve	group=settle
covenant	group=settle
annihilate	group=murder
assassinate	group=murder
bushwhack	group=murder
butcher	group=murder
dispatch	group=murder
eliminate	group=murder
euthanize	group=murder
execute	group=murder
exterminate	group=murder
immolate	group=murder
liquidate	group=murder
lynch	group=murder
massacre	group=murder
murder	group=murder
off	group=murder
slaughter	group=murder
slay	group=murder
kill	group=murder
count	group=characterize
depict	group=characterize
detail	group=characterize
envision	group=characterize
interpret	group=characterize
moot	group=characterize
peg	group=characterize
picture	group=characterize
pigeonhole	group=characterize
paint	group=characterize
recast	group=characterize
redraw	group=characterize
specify	group=characterize
stereotype	group=characterize
typecast	group=characterize
bill	group=characterize
cast	group=characterize
diagnose	group=characterize
certify	group=characterize
praise	group=characterize
hail	group=characterize
regard	group=characterize
treat	group=characterize
rank	group=characterize
take	group=characterize
perceive	group=characterize
judge	group=characterize
adopt	group=characterize
class	group=characterize
classify	group=characterize
select	group=characterize
subselect	group=characterize
pidgeonhole	group=characterize
stamp	group=characterize
characterize	group=characterize
conceive	group=characterize
see	group=characterize
view	group=characterize
know	group=characterize
underestimate	group=characterize
portray	group=characterize
define	group=characterize
describe	group=characterize
represent	group=characterize
accept	group=characterize
envisage	group=characterize
identify	group=characterize
imagine	group=characterize
visualize	group=characterize
remember	group=characterize
recollect	group=characterize
report	group=characterize
reveal	group=characterize
butcher	group=captain
judge	group=captain
lawyer	group=captain
midwife	group=captain
model	group=captain
prostitute	group=captain
soldier	group=captain
volunteer	group=captain
whore	group=captain
babysit	group=captain
boss	group=captain
bully	group=captain
butler	group=captain
caddy	group=captain
captain	group=captain
champion	group=captain
chaperone	group=captain
chauffeur	group=captain
clerk	group=captain
coach	group=captain
cox	group=captain
crew	group=captain
doctor	group=captain
emcee	group=captain
escort	group=captain
guard	group=captain
host	group=captain
mother	group=captain
nurse	group=captain
partner	group=captain
pilot	group=captain
pioneer	group=captain
police	group=captain
referee	group=captain
shepherd	group=captain
skipper	group=captain
sponsor	group=captain
tailor	group=captain
tutor	group=captain
umpire	group=captain
understudy	group=captain
usher	group=captain
valet	group=captain
witness	group=captain
star	group=captain
bob	group=braid
braid	group=braid
brush	group=braid
clip	group=braid
coldcream	group=braid
comb	group=braid
condition	group=braid
crimp	group=braid
crop	group=braid
curl	group=braid
cut	group=braid
dye	group=braid
file	group=braid
gel	group=braid
henna	group=braid
highlight	group=braid
lather	group=braid
manicure	group=braid
part	group=braid
perm	group=braid
paint	group=braid
plait	group=braid
pluck	group=braid
powder	group=braid
rinse	group=braid
rouge	group=braid
set	group=braid
shampoo	group=braid
soap	group=braid
style	group=braid
talc	group=braid
tease	group=braid
towel	group=braid
trim	group=braid
tweeze	group=braid
wave	group=braid
wax	group=braid
ally	group=conspire
collaborate	group=conspire
collude	group=conspire
conspire	group=conspire
discriminate	group=conspire
legislate	group=conspire
partner	group=conspire
protest	group=conspire
rebel	group=conspire
retaliate	group=conspire
scheme	group=conspire
sin	group=conspire
team up	group=conspire
befriend	group=conspire
block	group=concealment
cloister	group=concealment
conceal	group=concealment
curtain	group=concealment
impound	group=concealment
isolate	group=concealment
quarantine	group=concealment
repress	group=concealment
screen	group=concealment
seclude	group=concealment
sequester	group=concealment
shelter	group=concealment
suppress	group=concealment
hide	group=concealment
asphyxiate	group=suffocate
choke	group=suffocate
drown	group=suffocate
starve	group=suffocate
stifle	group=suffocate
suffocate	group=suffocate
omit	group=neglect
neglect	group=neglect
fail	group=neglect
forego	group=neglect
forgo	group=neglect
flub	group=neglect
overleap	group=neglect
manage	group=neglect
